Trade,Open Time,Order,Close Time,Open Price,Close Price,Return ($),Balance,Return (Pips),Trade Classification
0,1/3/2012 5:00,Sell,1/3/2012 5:00,0.78655,0.78705,($6.00),"$9,994.00 ",-5,Losing
1,1/3/2012 11:00,Sell,1/3/2012 11:00,0.79026,0.78995,$2.10 ,"$9,996.10 ",3.1,Neutral
2,1/4/2012 2:00,Sell,1/4/2012 2:00,0.78978,0.78788,$18.00 ,"$10,014.10 ",19,Winning
3,1/5/2012 6:00,Buy,1/5/2012 6:00,0.78077,0.78174,$8.70 ,"$10,022.80 ",9.7,Winning
4,1/5/2012 8:00,Sell,1/5/2012 8:00,0.78247,0.78305,($6.80),"$10,016.00 ",-5.8,Losing
5,1/5/2012 17:00,Buy,1/5/2012 17:00,0.77939,0.78071,$12.20 ,"$10,028.20 ",13.2,Winning
6,1/6/2012 0:00,Buy,1/6/2012 0:00,0.77933,0.77916,($2.70),"$10,025.50 ",-1.7,Neutral
7,1/9/2012 2:00,Sell,1/9/2012 3:00,0.78161,0.78499,($34.80),"$9,990.70 ",-33.8,Losing
8,1/12/2012 22:00,Buy,1/12/2012 22:00,0.79107,0.79056,($6.10),"$9,984.60 ",-5.1,Losing
9,1/16/2012 6:00,Buy,1/16/2012 6:00,0.79191,0.79246,$4.50 ,"$9,989.10 ",5.5,Winning
10,1/17/2012 8:00,Buy,1/17/2012 10:00,0.80002,0.79991,($2.10),"$9,987.00 ",-1.1,Neutral
11,1/17/2012 19:00,Sell,1/17/2012 19:00,0.80052,0.80048,($0.60),"$9,986.40 ",0.4,Neutral
12,1/17/2012 21:00,Sell,1/17/2012 21:00,0.80083,0.8015,($7.70),"$9,978.70 ",-6.7,Losing
13,1/18/2012 18:00,Buy,1/18/2012 18:00,0.80219,0.8031,$8.10 ,"$9,986.80 ",9.1,Winning
14,1/18/2012 20:00,Buy,1/18/2012 21:00,0.80208,0.80202,($1.60),"$9,985.20 ",-0.6,Neutral
15,1/19/2012 0:00,Sell,1/19/2012 0:00,0.80219,0.80134,$7.50 ,"$9,992.70 ",8.5,Winning
16,1/22/2012 23:00,Sell,1/23/2012 0:00,0.8067,0.80716,($5.60),"$9,987.10 ",-4.6,Neutral
17,1/23/2012 17:00,Buy,1/23/2012 17:00,0.80917,0.81051,$12.40 ,"$9,999.50 ",13.4,Winning
18,1/23/2012 19:00,Sell,1/23/2012 19:00,0.81115,0.81166,($6.10),"$9,993.40 ",-5.1,Losing
19,1/23/2012 23:00,Buy,1/23/2012 23:00,0.80874,0.8099,$10.60 ,"$10,004.00 ",11.6,Winning
20,1/24/2012 13:00,Sell,1/24/2012 13:00,0.81045,0.81033,$0.20 ,"$10,004.20 ",1.2,Neutral
21,1/25/2012 14:00,Sell,1/25/2012 14:00,0.81419,0.81293,$11.60 ,"$10,015.80 ",12.6,Winning
22,1/26/2012 1:00,Sell,1/26/2012 1:00,0.81869,0.8189,($3.10),"$10,012.70 ",-2.1,Neutral
23,1/26/2012 13:00,Buy,1/26/2012 13:00,0.81973,0.81897,($8.60),"$10,004.10 ",-7.6,Losing
24,1/26/2012 17:00,Sell,1/26/2012 17:00,0.82167,0.82098,$5.90 ,"$10,010.00 ",6.9,Winning
25,1/26/2012 20:00,Buy,1/26/2012 20:00,0.81888,0.81993,$9.50 ,"$10,019.50 ",10.5,Winning
26,1/27/2012 9:00,Buy,1/27/2012 9:00,0.82024,0.82283,$24.90 ,"$10,044.40 ",25.9,Winning
27,1/29/2012 17:00,Sell,1/29/2012 17:00,0.82439,0.82255,$17.40 ,"$10,061.80 ",18.4,Winning
28,1/30/2012 12:00,Sell,1/30/2012 12:00,0.81956,0.81958,($1.20),"$10,060.60 ",-0.2,Neutral
29,1/31/2012 10:00,Buy,1/31/2012 10:00,0.82717,0.82625,($10.20),"$10,050.40 ",-9.2,Losing
30,1/31/2012 12:00,Buy,1/31/2012 12:00,0.82437,0.82573,$12.60 ,"$10,063.00 ",13.6,Winning
31,1/31/2012 14:00,Sell,1/31/2012 14:00,0.82574,0.82463,$10.10 ,"$10,073.10 ",11.1,Winning
32,1/31/2012 17:00,Sell,1/31/2012 17:00,0.82646,0.82591,$4.50 ,"$10,077.60 ",5.5,Winning
33,2/1/2012 7:00,Sell,2/1/2012 7:00,0.82949,0.83206,($26.70),"$10,050.90 ",-25.7,Losing
34,2/1/2012 14:00,Buy,2/1/2012 16:00,0.8323,0.83229,($1.10),"$10,049.80 ",-0.1,Neutral
35,2/1/2012 18:00,Sell,2/1/2012 18:00,0.83245,0.8331,($7.50),"$10,042.30 ",-6.5,Losing
36,2/2/2012 14:00,Buy,2/2/2012 14:00,0.83307,0.83347,$3.00 ,"$10,045.30 ",4,Neutral
37,2/2/2012 16:00,Buy,2/2/2012 16:00,0.8331,0.83295,($2.50),"$10,042.80 ",-1.5,Neutral
38,2/2/2012 18:00,Buy,2/2/2012 19:00,0.83173,0.83156,($2.70),"$10,040.10 ",-1.7,Neutral
39,2/2/2012 20:00,Sell,2/2/2012 20:00,0.83156,0.83143,$0.30 ,"$10,040.40 ",1.3,Neutral
40,2/6/2012 3:00,Sell,2/6/2012 3:00,0.83185,0.83056,$11.90 ,"$10,052.30 ",12.9,Winning
41,2/10/2012 4:00,Sell,2/10/2012 4:00,0.82881,0.82925,($5.40),"$10,046.90 ",-4.4,Neutral
42,2/10/2012 7:00,Buy,2/10/2012 7:00,0.82773,0.82637,($14.60),"$10,032.30 ",-13.6,Losing
43,2/10/2012 16:00,Buy,2/12/2012 17:00,0.82644,0.83034,$38.00 ,"$10,070.30 ",39,Winning
44,2/13/2012 10:00,Buy,2/13/2012 10:00,0.83349,0.83379,$2.00 ,"$10,072.30 ",3,Neutral
45,2/14/2012 1:00,Sell,2/14/2012 1:00,0.82974,0.82967,($0.30),"$10,072.00 ",0.7,Neutral
46,2/15/2012 21:00,Sell,2/15/2012 21:00,0.8308,0.82747,$32.30 ,"$10,104.30 ",33.3,Winning
47,2/16/2012 19:00,Sell,2/16/2012 19:00,0.8356,0.83547,$0.30 ,"$10,104.60 ",1.3,Neutral
48,2/17/2012 9:00,Buy,2/17/2012 10:00,0.8353,0.83385,($15.50),"$10,089.10 ",-14.5,Losing
49,2/21/2012 8:00,Sell,2/21/2012 8:00,0.83468,0.83502,($4.40),"$10,084.70 ",-3.4,Neutral
50,2/21/2012 10:00,Sell,2/21/2012 11:00,0.83433,0.836,($17.70),"$10,067.00 ",-16.7,Losing
51,2/21/2012 18:00,Buy,2/21/2012 18:00,0.83277,0.83509,$22.20 ,"$10,089.20 ",23.2,Winning
52,2/21/2012 20:00,Sell,2/21/2012 21:00,0.83333,0.83108,$21.50 ,"$10,110.70 ",22.5,Winning
53,2/21/2012 22:00,Buy,2/21/2012 22:00,0.83108,0.83316,$19.80 ,"$10,130.50 ",20.8,Winning
54,2/22/2012 1:00,Sell,2/22/2012 1:00,0.83405,0.83458,($6.30),"$10,124.20 ",-5.3,Losing
55,2/22/2012 4:00,Buy,2/22/2012 4:00,0.83274,0.83245,($3.90),"$10,120.30 ",-2.9,Neutral
56,2/22/2012 7:00,Buy,2/22/2012 7:00,0.83093,0.8307,($3.30),"$10,117.00 ",-2.3,Neutral
57,2/23/2012 2:00,Sell,2/23/2012 2:00,0.83071,0.83026,$3.50 ,"$10,120.50 ",4.5,Neutral
58,2/23/2012 19:00,Sell,2/23/2012 19:00,0.83713,0.8374,($3.70),"$10,116.80 ",-2.7,Neutral
59,2/24/2012 9:00,Buy,2/24/2012 9:00,0.83628,0.83615,($2.30),"$10,114.50 ",-1.3,Neutral
60,2/24/2012 15:00,Sell,2/24/2012 15:00,0.83615,0.83548,$5.70 ,"$10,120.20 ",6.7,Winning
61,2/28/2012 13:00,Sell,2/28/2012 13:00,0.83635,0.8352,$10.50 ,"$10,130.70 ",11.5,Winning
62,2/29/2012 12:00,Buy,2/29/2012 14:00,0.83944,0.83749,($20.50),"$10,110.20 ",-19.5,Losing
63,2/29/2012 16:00,Buy,2/29/2012 17:00,0.83404,0.83424,$1.00 ,"$10,111.20 ",2,Neutral
64,2/29/2012 19:00,Sell,2/29/2012 19:00,0.83489,0.83534,($5.50),"$10,105.70 ",-4.5,Neutral
65,3/2/2012 6:00,Sell,3/2/2012 6:00,0.83409,0.83381,$1.80 ,"$10,107.50 ",2.8,Neutral
66,3/2/2012 8:00,Sell,3/2/2012 8:00,0.83358,0.83313,$3.50 ,"$10,111.00 ",4.5,Neutral
67,3/2/2012 10:00,Sell,3/2/2012 10:00,0.83285,0.83366,($9.10),"$10,101.90 ",-8.1,Losing
68,3/2/2012 14:00,Buy,3/2/2012 14:00,0.82926,0.82915,($2.10),"$10,099.80 ",-1.1,Neutral
69,3/4/2012 17:00,Buy,3/4/2012 17:00,0.82866,0.82895,$1.90 ,"$10,101.70 ",2.9,Neutral
70,3/4/2012 20:00,Sell,3/4/2012 20:00,0.82915,0.82958,($5.30),"$10,096.40 ",-4.3,Neutral
71,3/4/2012 22:00,Buy,3/4/2012 22:00,0.82819,0.82782,($4.70),"$10,091.70 ",-3.7,Neutral
72,3/6/2012 22:00,Sell,3/6/2012 22:00,0.81584,0.81612,($3.80),"$10,087.90 ",-2.8,Neutral
73,3/7/2012 16:00,Buy,3/7/2012 16:00,0.81558,0.81627,$5.90 ,"$10,093.80 ",6.9,Winning
74,3/8/2012 10:00,Buy,3/8/2012 11:00,0.8231,0.82396,$7.60 ,"$10,101.40 ",8.6,Winning
75,3/8/2012 17:00,Buy,3/8/2012 17:00,0.82397,0.82401,($0.60),"$10,100.80 ",0.4,Neutral
76,3/8/2012 19:00,Buy,3/8/2012 19:00,0.82381,0.82368,($2.30),"$10,098.50 ",-1.3,Neutral
77,3/9/2012 3:00,Buy,3/9/2012 4:00,0.82393,0.82408,$0.50 ,"$10,099.00 ",1.5,Neutral
78,3/9/2012 9:00,Sell,3/9/2012 9:00,0.82176,0.81958,$20.80 ,"$10,119.80 ",21.8,Winning
79,3/14/2012 10:00,Buy,3/14/2012 10:00,0.81185,0.81108,($8.70),"$10,111.10 ",-7.7,Losing
80,3/14/2012 12:00,Sell,3/14/2012 12:00,0.80911,0.80958,($5.70),"$10,105.40 ",-4.7,Neutral
81,3/15/2012 17:00,Buy,3/15/2012 17:00,0.81885,0.81952,$5.70 ,"$10,111.10 ",6.7,Winning
82,3/15/2012 19:00,Buy,3/15/2012 19:00,0.8187,0.81875,($0.50),"$10,110.60 ",0.5,Neutral
83,3/16/2012 3:00,Buy,3/16/2012 4:00,0.81959,0.81886,($8.30),"$10,102.30 ",-7.3,Losing
84,3/16/2012 6:00,Buy,3/16/2012 6:00,0.81786,0.819,$10.40 ,"$10,112.70 ",11.4,Winning
85,3/16/2012 10:00,Sell,3/16/2012 10:00,0.82374,0.8236,$0.40 ,"$10,113.10 ",1.4,Neutral
86,3/16/2012 16:00,Buy,3/16/2012 16:00,0.8235,0.82385,$2.50 ,"$10,115.60 ",3.5,Neutral
87,3/19/2012 5:00,Buy,3/19/2012 5:00,0.8233,0.8251,$17.00 ,"$10,132.60 ",18,Winning
88,3/21/2012 7:00,Buy,3/21/2012 11:00,0.81685,0.81348,($34.70),"$10,097.90 ",-33.7,Losing
89,3/21/2012 12:00,Sell,3/21/2012 12:00,0.81348,0.81428,($9.00),"$10,088.90 ",-8,Losing
90,3/22/2012 3:00,Sell,3/22/2012 3:00,0.80903,0.808,$9.30 ,"$10,098.20 ",10.3,Winning
91,3/25/2012 22:00,Buy,3/25/2012 23:00,0.8162,0.8165,$2.00 ,"$10,100.20 ",3,Neutral
92,3/26/2012 1:00,Buy,3/26/2012 1:00,0.81575,0.81565,($2.00),"$10,098.20 ",-1,Neutral
93,3/26/2012 2:00,Sell,3/26/2012 2:00,0.81565,0.81593,($3.80),"$10,094.40 ",-2.8,Neutral
94,3/26/2012 18:00,Sell,3/26/2012 18:00,0.8233,0.82191,$12.90 ,"$10,107.30 ",13.9,Winning
95,3/27/2012 0:00,Buy,3/27/2012 0:00,0.82146,0.82183,$2.70 ,"$10,110.00 ",3.7,Neutral
96,3/27/2012 4:00,Sell,3/27/2012 4:00,0.82398,0.82478,($9.00),"$10,101.00 ",-8,Losing
97,3/27/2012 10:00,Buy,3/27/2012 10:00,0.82129,0.82092,($4.70),"$10,096.30 ",-3.7,Neutral
98,3/27/2012 23:00,Sell,3/27/2012 23:00,0.81903,0.81806,$8.70 ,"$10,105.00 ",9.7,Winning
99,3/28/2012 3:00,Sell,3/28/2012 3:00,0.81821,0.82065,($25.40),"$10,079.60 ",-24.4,Losing
100,3/30/2012 10:00,Buy,3/30/2012 11:00,0.82046,0.81983,($7.30),"$10,072.30 ",-6.3,Losing
101,4/1/2012 18:00,Sell,4/1/2012 18:00,0.82396,0.82304,$8.20 ,"$10,080.50 ",9.2,Winning
102,4/3/2012 23:00,Sell,4/3/2012 23:00,0.81666,0.81676,($2.00),"$10,078.50 ",-1,Neutral
103,4/4/2012 7:00,Sell,4/4/2012 7:00,0.81417,0.81473,($6.60),"$10,071.90 ",-5.6,Losing
104,4/4/2012 21:00,Sell,4/4/2012 21:00,0.81607,0.81502,$9.50 ,"$10,081.40 ",10.5,Winning
105,4/9/2012 9:00,Sell,4/9/2012 9:00,0.81978,0.81888,$8.00 ,"$10,089.40 ",9,Winning
106,4/9/2012 17:00,Buy,4/9/2012 17:00,0.8214,0.82142,($0.80),"$10,088.60 ",0.2,Neutral
107,4/9/2012 19:00,Buy,4/9/2012 19:00,0.82065,0.82056,($1.90),"$10,086.70 ",-0.9,Neutral
108,4/10/2012 15:00,Sell,4/10/2012 15:00,0.81335,0.81417,($9.20),"$10,077.50 ",-8.2,Losing
109,4/10/2012 18:00,Sell,4/10/2012 18:00,0.81554,0.81482,$6.20 ,"$10,083.70 ",7.2,Winning
110,4/13/2012 10:00,Buy,4/13/2012 12:00,0.8272,0.82426,($30.40),"$10,053.30 ",-29.4,Losing
111,4/13/2012 14:00,Buy,4/13/2012 14:00,0.82375,0.82468,$8.30 ,"$10,061.60 ",9.3,Winning
112,4/13/2012 16:00,Sell,4/13/2012 16:00,0.82352,0.82208,$13.40 ,"$10,075.00 ",14.4,Winning
113,4/15/2012 17:00,Buy,4/15/2012 17:00,0.82208,0.8231,$9.20 ,"$10,084.20 ",10.2,Winning
114,4/15/2012 20:00,Buy,4/15/2012 20:00,0.82136,0.81938,($20.80),"$10,063.40 ",-19.8,Losing
115,4/16/2012 23:00,Sell,4/17/2012 1:00,0.81686,0.81572,$10.40 ,"$10,073.80 ",11.4,Winning
116,4/17/2012 16:00,Buy,4/17/2012 17:00,0.82146,0.82137,($1.90),"$10,071.90 ",-0.9,Neutral
117,4/17/2012 21:00,Sell,4/17/2012 21:00,0.82238,0.82146,$8.20 ,"$10,080.10 ",9.2,Winning
118,4/18/2012 16:00,Buy,4/18/2012 16:00,0.81465,0.81573,$9.80 ,"$10,089.90 ",10.8,Winning
119,4/19/2012 12:00,Sell,4/19/2012 12:00,0.81466,0.81352,$10.40 ,"$10,100.30 ",11.4,Winning
120,4/19/2012 18:00,Sell,4/19/2012 19:00,0.81434,0.81435,($1.10),"$10,099.20 ",-0.1,Neutral
121,4/19/2012 22:00,Buy,4/19/2012 22:00,0.81238,0.8131,$6.20 ,"$10,105.40 ",7.2,Winning
122,4/23/2012 1:00,Sell,4/23/2012 1:00,0.81624,0.8154,$7.40 ,"$10,112.80 ",8.4,Winning
123,4/23/2012 7:00,Buy,4/23/2012 7:00,0.81092,0.81125,$2.30 ,"$10,115.10 ",3.3,Neutral
124,4/27/2012 13:00,Sell,4/27/2012 13:00,0.82215,0.82251,($4.60),"$10,110.50 ",-3.6,Neutral
125,5/1/2012 13:00,Sell,5/1/2012 13:00,0.81571,0.81568,($0.70),"$10,109.80 ",0.3,Neutral
126,5/1/2012 17:00,Buy,5/1/2012 18:00,0.81488,0.81482,($1.60),"$10,108.20 ",-0.6,Neutral
127,5/2/2012 10:00,Buy,5/2/2012 10:00,0.81028,0.80999,($3.90),"$10,104.30 ",-2.9,Neutral
128,5/7/2012 16:00,Buy,5/7/2012 16:00,0.79447,0.79447,($1.00),"$10,103.30 ",0,Neutral
129,5/8/2012 7:00,Sell,5/8/2012 7:00,0.78993,0.7918,($19.70),"$10,083.60 ",-18.7,Losing
130,5/8/2012 13:00,Buy,5/8/2012 13:00,0.78654,0.78842,$17.80 ,"$10,101.40 ",18.8,Winning
131,5/8/2012 19:00,Buy,5/8/2012 21:00,0.78644,0.78497,($15.70),"$10,085.70 ",-14.7,Losing
132,5/8/2012 23:00,Buy,5/9/2012 0:00,0.78473,0.78484,$0.10 ,"$10,085.80 ",1.1,Neutral
133,5/14/2012 8:00,Sell,5/14/2012 8:00,0.77793,0.778,($1.70),"$10,084.10 ",-0.7,Neutral
134,5/14/2012 12:00,Sell,5/14/2012 12:00,0.7795,0.77935,$0.50 ,"$10,084.60 ",1.5,Neutral
135,5/14/2012 16:00,Buy,5/14/2012 17:00,0.77754,0.7769,($7.40),"$10,077.20 ",-6.4,Losing
136,5/14/2012 19:00,Buy,5/14/2012 19:00,0.77639,0.77698,$4.90 ,"$10,082.10 ",5.9,Winning
137,5/17/2012 10:00,Sell,5/17/2012 10:00,0.7635,0.76526,($18.60),"$10,063.50 ",-17.6,Losing
138,5/18/2012 1:00,Buy,5/18/2012 1:00,0.75636,0.75629,($1.70),"$10,061.80 ",-0.7,Neutral
139,5/18/2012 3:00,Sell,5/18/2012 3:00,0.75598,0.7561,($2.20),"$10,059.60 ",-1.2,Neutral
140,5/18/2012 12:00,Buy,5/18/2012 13:00,0.75399,0.75249,($16.00),"$10,043.60 ",-15,Losing
141,5/18/2012 15:00,Buy,5/18/2012 15:00,0.75302,0.75362,$5.00 ,"$10,048.60 ",6,Winning
142,5/20/2012 20:00,Sell,5/20/2012 20:00,0.75772,0.75849,($8.70),"$10,039.90 ",-7.7,Losing
143,5/21/2012 20:00,Sell,5/21/2012 20:00,0.7669,0.76623,$5.70 ,"$10,045.60 ",6.7,Winning
144,5/22/2012 3:00,Sell,5/22/2012 3:00,0.76575,0.76534,$3.10 ,"$10,048.70 ",4.1,Neutral
145,5/22/2012 6:00,Buy,5/22/2012 6:00,0.76104,0.76081,($3.30),"$10,045.40 ",-2.3,Neutral
146,5/22/2012 8:00,Sell,5/22/2012 8:00,0.76175,0.76087,$7.80 ,"$10,053.20 ",8.8,Winning
147,5/22/2012 18:00,Sell,5/22/2012 18:00,0.75424,0.7545,($3.60),"$10,049.60 ",-2.6,Neutral
148,5/22/2012 20:00,Buy,5/22/2012 20:00,0.75214,0.75015,($20.90),"$10,028.70 ",-19.9,Losing
149,5/23/2012 20:00,Buy,5/23/2012 20:00,0.74887,0.75078,$18.10 ,"$10,046.80 ",19.1,Winning
150,5/24/2012 4:00,Buy,5/24/2012 4:00,0.74955,0.74988,$2.30 ,"$10,049.10 ",3.3,Neutral
151,5/24/2012 9:00,Sell,5/24/2012 9:00,0.75578,0.75303,$26.50 ,"$10,075.60 ",27.5,Winning
152,5/28/2012 11:00,Buy,5/28/2012 11:00,0.76008,0.76006,($1.20),"$10,074.40 ",-0.2,Neutral
153,6/1/2012 2:00,Sell,6/1/2012 2:00,0.75239,0.75183,$4.60 ,"$10,079.00 ",5.6,Winning
154,6/6/2012 9:00,Buy,6/6/2012 9:00,0.76034,0.76479,$43.50 ,"$10,122.50 ",44.5,Winning
155,6/6/2012 12:00,Sell,6/6/2012 12:00,0.7679,0.76875,($9.50),"$10,113.00 ",-8.5,Losing
156,6/6/2012 21:00,Buy,6/6/2012 21:00,0.76883,0.77108,$21.50 ,"$10,134.50 ",22.5,Winning
157,6/7/2012 7:00,Sell,6/7/2012 7:00,0.77214,0.77365,($16.10),"$10,118.40 ",-15.1,Losing
158,6/7/2012 21:00,Sell,6/7/2012 21:00,0.76566,0.76388,$16.80 ,"$10,135.20 ",17.8,Winning
159,6/8/2012 2:00,Buy,6/8/2012 2:00,0.7625,0.76318,$5.80 ,"$10,141.00 ",6.8,Winning
160,6/8/2012 11:00,Sell,6/8/2012 11:00,0.76734,0.76702,$2.20 ,"$10,143.20 ",3.2,Neutral
161,6/8/2012 14:00,Sell,6/8/2012 14:00,0.76912,0.76949,($4.70),"$10,138.50 ",-3.7,Neutral
162,6/11/2012 6:00,Buy,6/11/2012 6:00,0.77384,0.77413,$1.90 ,"$10,140.40 ",2.9,Neutral
163,6/11/2012 10:00,Buy,6/11/2012 10:00,0.77307,0.77278,($3.90),"$10,136.50 ",-2.9,Neutral
164,6/11/2012 13:00,Sell,6/11/2012 13:00,0.7725,0.77205,$3.50 ,"$10,140.00 ",4.5,Neutral
165,6/11/2012 16:00,Buy,6/11/2012 16:00,0.76894,0.76887,($1.70),"$10,138.30 ",-0.7,Neutral
166,6/11/2012 19:00,Buy,6/11/2012 19:00,0.76759,0.76852,$8.30 ,"$10,146.60 ",9.3,Winning
167,6/13/2012 12:00,Buy,6/13/2012 12:00,0.77791,0.77851,$5.00 ,"$10,151.60 ",6,Winning
168,6/13/2012 15:00,Buy,6/13/2012 15:00,0.77754,0.77465,($29.90),"$10,121.70 ",-28.9,Losing
169,6/13/2012 17:00,Buy,6/13/2012 17:00,0.7726,0.77602,$33.20 ,"$10,154.90 ",34.2,Winning
170,6/15/2012 5:00,Sell,6/15/2012 5:00,0.78585,0.78533,$4.20 ,"$10,159.10 ",5.2,Winning
171,6/15/2012 15:00,Sell,6/15/2012 15:00,0.78999,0.78925,$6.40 ,"$10,165.50 ",7.4,Winning
172,6/18/2012 2:00,Sell,6/18/2012 2:00,0.79333,0.79326,($0.30),"$10,165.20 ",0.7,Neutral
173,6/18/2012 9:00,Buy,6/18/2012 9:00,0.78905,0.79108,$19.30 ,"$10,184.50 ",20.3,Winning
174,6/19/2012 19:00,Buy,6/19/2012 19:00,0.79656,0.79523,($14.30),"$10,170.20 ",-13.3,Losing
175,6/22/2012 4:00,Buy,6/22/2012 4:00,0.78478,0.78676,$18.80 ,"$10,189.00 ",19.8,Winning
176,6/22/2012 8:00,Sell,6/22/2012 8:00,0.78946,0.78876,$6.00 ,"$10,195.00 ",7,Winning
177,6/22/2012 10:00,Sell,6/22/2012 10:00,0.7904,0.78966,$6.40 ,"$10,201.40 ",7.4,Winning
178,6/24/2012 23:00,Sell,6/24/2012 23:00,0.78679,0.78777,($10.80),"$10,190.60 ",-9.8,Losing
179,6/25/2012 21:00,Sell,6/25/2012 21:00,0.78883,0.78947,($7.40),"$10,183.20 ",-6.4,Losing
180,6/28/2012 4:00,Buy,6/28/2012 4:00,0.79244,0.79194,($6.00),"$10,177.20 ",-5,Losing
181,6/28/2012 17:00,Sell,6/28/2012 17:00,0.78792,0.78768,$1.40 ,"$10,178.60 ",2.4,Neutral
182,6/29/2012 11:00,Sell,6/29/2012 11:00,0.80371,0.80243,$11.80 ,"$10,190.40 ",12.8,Winning
183,7/1/2012 19:00,Sell,7/1/2012 19:00,0.80041,0.80133,($10.20),"$10,180.20 ",-9.2,Losing
184,7/9/2012 8:00,Sell,7/9/2012 8:00,0.79398,0.79438,($5.00),"$10,175.20 ",-4,Neutral
185,7/10/2012 4:00,Sell,7/10/2012 4:00,0.79453,0.79681,($23.80),"$10,151.40 ",-22.8,Losing
186,7/10/2012 22:00,Sell,7/10/2012 22:00,0.7946,0.79511,($6.10),"$10,145.30 ",-5.1,Losing
187,7/12/2012 1:00,Sell,7/12/2012 1:00,0.79299,0.79179,$11.00 ,"$10,156.30 ",12,Winning
188,7/12/2012 6:00,Buy,7/12/2012 7:00,0.78862,0.78791,($8.10),"$10,148.20 ",-7.1,Losing
189,7/22/2012 20:00,Buy,7/22/2012 21:00,0.79636,0.7948,($16.60),"$10,131.60 ",-15.6,Losing
190,7/24/2012 12:00,Buy,7/24/2012 15:00,0.78732,0.78643,($9.90),"$10,121.70 ",-8.9,Losing
191,7/24/2012 17:00,Buy,7/24/2012 17:00,0.78388,0.78429,$3.10 ,"$10,124.80 ",4.1,Neutral
192,7/24/2012 21:00,Buy,7/24/2012 21:00,0.78158,0.78138,($3.00),"$10,121.80 ",-2,Neutral
193,7/25/2012 9:00,Sell,7/25/2012 9:00,0.78883,0.78724,$14.90 ,"$10,136.70 ",15.9,Winning
194,7/26/2012 20:00,Buy,7/26/2012 20:00,0.79978,0.7995,($3.80),"$10,132.90 ",-2.8,Neutral
195,7/27/2012 5:00,Buy,7/27/2012 5:00,0.80157,0.80375,$20.80 ,"$10,153.70 ",21.8,Winning
196,8/1/2012 10:00,Buy,8/1/2012 10:00,0.8107,0.81227,$14.70 ,"$10,168.40 ",15.7,Winning
197,8/2/2012 13:00,Buy,8/2/2012 13:00,0.80855,0.80805,($6.00),"$10,162.40 ",-5,Neutral
198,8/6/2012 4:00,Buy,8/6/2012 4:00,0.81667,0.81749,$7.20 ,"$10,169.60 ",8.2,Winning
199,8/6/2012 6:00,Sell,8/6/2012 6:00,0.81709,0.81752,($5.30),"$10,164.30 ",-4.3,Neutral
200,8/6/2012 11:00,Sell,8/6/2012 11:00,0.82122,0.82153,($4.10),"$10,160.20 ",-3.1,Neutral
201,8/6/2012 16:00,Buy,8/6/2012 17:00,0.81993,0.81974,($2.90),"$10,157.30 ",-1.9,Neutral
202,8/6/2012 20:00,Buy,8/6/2012 20:00,0.8194,0.82031,$8.10 ,"$10,165.40 ",9.1,Winning
203,8/6/2012 22:00,Sell,8/6/2012 22:00,0.82174,0.8214,$2.40 ,"$10,167.80 ",3.4,Neutral
204,8/7/2012 16:00,Buy,8/7/2012 16:00,0.81458,0.81551,$8.30 ,"$10,176.10 ",9.3,Winning
205,8/7/2012 17:00,Sell,8/7/2012 17:00,0.81551,0.81548,($0.70),"$10,175.40 ",0.3,Neutral
206,8/7/2012 23:00,Buy,8/8/2012 1:00,0.81342,0.8129,($6.20),"$10,169.20 ",-5.2,Losing
207,8/8/2012 3:00,Buy,8/8/2012 3:00,0.81221,0.81423,$19.20 ,"$10,188.40 ",20.2,Winning
208,8/8/2012 17:00,Sell,8/8/2012 17:00,0.81566,0.81526,$3.00 ,"$10,191.40 ",4,Neutral
209,8/14/2012 19:00,Sell,8/14/2012 19:00,0.80474,0.80469,($0.50),"$10,190.90 ",0.5,Neutral
210,8/14/2012 21:00,Buy,8/14/2012 21:00,0.80386,0.80437,$4.10 ,"$10,195.00 ",5.1,Winning
211,8/15/2012 1:00,Sell,8/15/2012 1:00,0.80533,0.8051,$1.30 ,"$10,196.30 ",2.3,Neutral
212,8/15/2012 4:00,Buy,8/15/2012 4:00,0.80393,0.8053,$12.70 ,"$10,209.00 ",13.7,Winning
213,8/15/2012 20:00,Sell,8/15/2012 20:00,0.80668,0.80788,($13.00),"$10,196.00 ",-12,Losing
214,8/16/2012 17:00,Buy,8/16/2012 17:00,0.80931,0.81083,$14.20 ,"$10,210.20 ",15.2,Winning
215,8/16/2012 23:00,Buy,8/16/2012 23:00,0.8107,0.81055,($2.50),"$10,207.70 ",-1.5,Neutral
216,8/17/2012 5:00,Sell,8/17/2012 5:00,0.80848,0.80804,$3.40 ,"$10,211.10 ",4.4,Neutral
217,8/20/2012 1:00,Sell,8/20/2012 1:00,0.80934,0.80844,$8.00 ,"$10,219.10 ",9,Winning
218,8/21/2012 17:00,Sell,8/21/2012 17:00,0.80999,0.81086,($9.70),"$10,209.40 ",-8.7,Losing
219,8/22/2012 2:00,Sell,8/22/2012 2:00,0.80799,0.80855,($6.60),"$10,202.80 ",-5.6,Losing
220,8/22/2012 20:00,Sell,8/22/2012 21:00,0.81569,0.81795,($23.60),"$10,179.20 ",-22.6,Losing
221,8/23/2012 9:00,Buy,8/23/2012 10:00,0.81533,0.81634,$9.10 ,"$10,188.30 ",10.1,Winning
222,8/23/2012 13:00,Buy,8/23/2012 14:00,0.81451,0.81365,($9.60),"$10,178.70 ",-8.6,Losing
223,8/23/2012 17:00,Buy,8/23/2012 17:00,0.8119,0.81246,$4.60 ,"$10,183.30 ",5.6,Winning
224,8/23/2012 19:00,Buy,8/23/2012 19:00,0.81199,0.81259,$5.00 ,"$10,188.30 ",6,Winning
225,8/27/2012 11:00,Buy,8/27/2012 11:00,0.80894,0.80958,$5.40 ,"$10,193.70 ",6.4,Winning
226,8/27/2012 20:00,Sell,8/27/2012 20:00,0.80823,0.80584,$22.90 ,"$10,216.60 ",23.9,Winning
227,8/27/2012 21:00,Buy,8/27/2012 21:00,0.80584,0.80652,$5.80 ,"$10,222.40 ",6.8,Winning
228,8/28/2012 10:00,Buy,8/28/2012 10:00,0.80508,0.80595,$7.70 ,"$10,230.10 ",8.7,Winning
229,8/28/2012 12:00,Sell,8/28/2012 12:00,0.80553,0.80518,$2.50 ,"$10,232.60 ",3.5,Neutral
230,8/28/2012 15:00,Buy,8/28/2012 15:00,0.80333,0.80452,$10.90 ,"$10,243.50 ",11.9,Winning
231,8/29/2012 5:00,Buy,8/29/2012 5:00,0.80166,0.80202,$2.60 ,"$10,246.10 ",3.6,Neutral
232,8/29/2012 15:00,Buy,8/29/2012 15:00,0.80179,0.80088,($10.10),"$10,236.00 ",-9.1,Losing
233,8/30/2012 11:00,Sell,8/30/2012 11:00,0.79901,0.79853,$3.80 ,"$10,239.80 ",4.8,Neutral
234,9/3/2012 9:00,Buy,9/3/2012 11:00,0.79752,0.7974,($2.20),"$10,237.60 ",-1.2,Neutral
235,9/3/2012 12:00,Sell,9/3/2012 14:00,0.7974,0.79727,$0.30 ,"$10,237.90 ",1.3,Neutral
236,9/4/2012 9:00,Buy,9/4/2012 9:00,0.79321,0.79391,$6.00 ,"$10,243.90 ",7,Winning
237,9/4/2012 10:00,Sell,9/4/2012 10:00,0.79391,0.79248,$13.30 ,"$10,257.20 ",14.3,Winning
238,9/4/2012 11:00,Buy,9/4/2012 11:00,0.79248,0.79382,$12.40 ,"$10,269.60 ",13.4,Winning
239,9/6/2012 2:00,Sell,9/6/2012 2:00,0.7969,0.79669,$1.10 ,"$10,270.70 ",2.1,Neutral
240,9/6/2012 7:00,Sell,9/6/2012 7:00,0.79767,0.7973,$2.70 ,"$10,273.40 ",3.7,Neutral
241,9/6/2012 19:00,Buy,9/6/2012 19:00,0.80054,0.80058,($0.60),"$10,272.80 ",0.4,Neutral
242,9/7/2012 7:00,Buy,9/7/2012 7:00,0.80244,0.80425,$17.10 ,"$10,289.90 ",18.1,Winning
243,9/10/2012 13:00,Sell,9/10/2012 13:00,0.80972,0.80919,$4.30 ,"$10,294.20 ",5.3,Winning
244,9/10/2012 14:00,Buy,9/10/2012 16:00,0.80919,0.80775,($15.40),"$10,278.80 ",-14.4,Losing
245,9/11/2012 4:00,Sell,9/11/2012 4:00,0.81159,0.81278,($12.90),"$10,265.90 ",-11.9,Losing
246,9/12/2012 19:00,Sell,9/12/2012 19:00,0.82084,0.8201,$6.40 ,"$10,272.30 ",7.4,Winning
247,9/12/2012 22:00,Sell,9/12/2012 22:00,0.82122,0.82133,($2.10),"$10,270.20 ",-1.1,Neutral
248,9/13/2012 3:00,Buy,9/13/2012 3:00,0.82019,0.81994,($3.50),"$10,266.70 ",-2.5,Neutral
249,9/13/2012 6:00,Sell,9/13/2012 6:00,0.82042,0.82139,($10.70),"$10,256.00 ",-9.7,Losing
250,9/13/2012 8:00,Sell,9/13/2012 8:00,0.82309,0.82352,($5.30),"$10,250.70 ",-4.3,Neutral
251,9/14/2012 15:00,Buy,9/14/2012 15:00,0.82897,0.82972,$6.50 ,"$10,257.20 ",7.5,Winning
252,9/16/2012 19:00,Sell,9/16/2012 19:00,0.82902,0.8285,$4.20 ,"$10,261.40 ",5.2,Winning
253,9/16/2012 20:00,Buy,9/16/2012 20:00,0.8285,0.82882,$2.20 ,"$10,263.60 ",3.2,Neutral
254,9/16/2012 23:00,Buy,9/16/2012 23:00,0.82763,0.82773,$0.00 ,"$10,263.60 ",1,Neutral
255,9/17/2012 2:00,Sell,9/17/2012 2:00,0.82814,0.82781,$2.30 ,"$10,265.90 ",3.3,Neutral
256,9/20/2012 4:00,Sell,9/20/2012 4:00,0.82287,0.82345,($6.80),"$10,259.10 ",-5.8,Losing
257,9/21/2012 5:00,Sell,9/21/2012 5:00,0.83248,0.83244,($0.60),"$10,258.50 ",0.4,Neutral
258,9/21/2012 11:00,Buy,9/21/2012 12:00,0.83049,0.83006,($5.30),"$10,253.20 ",-4.3,Neutral
259,9/24/2012 7:00,Buy,9/24/2012 7:00,0.82069,0.82099,$2.00 ,"$10,255.20 ",3,Neutral
260,9/24/2012 14:00,Buy,9/24/2012 14:00,0.81978,0.8217,$18.20 ,"$10,273.40 ",19.2,Winning
261,9/24/2012 17:00,Sell,9/24/2012 17:00,0.82272,0.82238,$2.40 ,"$10,275.80 ",3.4,Neutral
262,9/24/2012 22:00,Sell,9/24/2012 22:00,0.823,0.82361,($7.10),"$10,268.70 ",-6.1,Losing
263,9/25/2012 22:00,Sell,9/25/2012 22:00,0.81972,0.81896,$6.60 ,"$10,275.30 ",7.6,Winning
264,9/25/2012 23:00,Buy,9/25/2012 23:00,0.81896,0.82032,$12.60 ,"$10,287.90 ",13.6,Winning
265,9/26/2012 2:00,Sell,9/26/2012 2:00,0.81932,0.81994,($7.20),"$10,280.70 ",-6.2,Losing
266,9/26/2012 13:00,Sell,9/26/2012 13:00,0.8239,0.82325,$5.50 ,"$10,286.20 ",6.5,Winning
267,9/28/2012 7:00,Buy,9/28/2012 7:00,0.83085,0.83271,$17.60 ,"$10,303.80 ",18.6,Winning
268,9/28/2012 10:00,Buy,9/28/2012 10:00,0.82908,0.83058,$14.00 ,"$10,317.80 ",15,Winning
269,9/28/2012 15:00,Buy,9/28/2012 15:00,0.82826,0.82865,$2.90 ,"$10,320.70 ",3.9,Neutral
270,9/30/2012 18:00,Sell,9/30/2012 18:00,0.82856,0.82787,$5.90 ,"$10,326.60 ",6.9,Winning
271,9/30/2012 19:00,Buy,9/30/2012 19:00,0.82787,0.82737,($6.00),"$10,320.60 ",-5,Neutral
272,10/1/2012 5:00,Sell,10/1/2012 5:00,0.83167,0.83042,$11.50 ,"$10,332.10 ",12.5,Winning
273,10/2/2012 22:00,Sell,10/2/2012 22:00,0.82431,0.82285,$13.60 ,"$10,345.70 ",14.6,Winning
274,10/3/2012 3:00,Buy,10/3/2012 5:00,0.8211,0.82233,$11.30 ,"$10,357.00 ",12.3,Winning
275,10/3/2012 10:00,Buy,10/3/2012 10:00,0.81968,0.8198,$0.20 ,"$10,357.20 ",1.2,Neutral
276,10/3/2012 14:00,Buy,10/3/2012 15:00,0.81874,0.81821,($6.30),"$10,350.90 ",-5.3,Losing
277,10/4/2012 5:00,Buy,10/4/2012 5:00,0.8198,0.82035,$4.50 ,"$10,355.40 ",5.5,Winning
278,10/4/2012 10:00,Buy,10/4/2012 10:00,0.81752,0.81961,$19.90 ,"$10,375.30 ",20.9,Winning
279,10/5/2012 12:00,Buy,10/5/2012 12:00,0.82286,0.8223,($6.60),"$10,368.70 ",-5.6,Losing
280,10/5/2012 14:00,Buy,10/5/2012 14:00,0.81937,0.81681,($26.60),"$10,342.10 ",-25.6,Losing
281,10/7/2012 17:00,Sell,10/7/2012 18:00,0.8175,0.81756,($1.60),"$10,340.50 ",-0.6,Neutral
282,10/7/2012 21:00,Sell,10/7/2012 21:00,0.81938,0.81774,$15.40 ,"$10,355.90 ",16.4,Winning
283,10/12/2012 4:00,Sell,10/12/2012 4:00,0.82077,0.81936,$13.10 ,"$10,369.00 ",14.1,Winning
284,10/14/2012 19:00,Buy,10/14/2012 20:00,0.81495,0.81364,($14.10),"$10,354.90 ",-13.1,Losing
285,10/16/2012 8:00,Sell,10/16/2012 8:00,0.81494,0.81411,$7.30 ,"$10,362.20 ",8.3,Winning
286,10/16/2012 16:00,Sell,10/16/2012 17:00,0.81378,0.81697,($32.90),"$10,329.30 ",-31.9,Losing
287,10/17/2012 10:00,Sell,10/17/2012 10:00,0.82207,0.82127,$7.00 ,"$10,336.30 ",8,Winning
288,10/17/2012 19:00,Buy,10/17/2012 19:00,0.82093,0.82148,$4.50 ,"$10,340.80 ",5.5,Winning
289,10/19/2012 14:00,Sell,10/19/2012 14:00,0.81612,0.81573,$2.90 ,"$10,343.70 ",3.9,Neutral
290,10/21/2012 19:00,Sell,10/21/2012 19:00,0.81533,0.81538,($1.50),"$10,342.20 ",-0.5,Neutral
291,10/22/2012 1:00,Sell,10/22/2012 1:00,0.81837,0.81835,($0.80),"$10,341.40 ",0.2,Neutral
292,10/23/2012 9:00,Buy,10/23/2012 9:00,0.8115,0.81214,$5.40 ,"$10,346.80 ",6.4,Winning
293,10/23/2012 12:00,Sell,10/23/2012 12:00,0.81124,0.8119,($7.60),"$10,339.20 ",-6.6,Losing
294,10/24/2012 7:00,Sell,10/24/2012 7:00,0.81429,0.81437,($1.80),"$10,337.40 ",-0.8,Neutral
295,10/24/2012 21:00,Sell,10/24/2012 21:00,0.82211,0.82269,($6.80),"$10,330.60 ",-5.8,Losing
296,10/25/2012 11:00,Buy,10/25/2012 11:00,0.82165,0.82074,($10.10),"$10,320.50 ",-9.1,Losing
297,10/26/2012 1:00,Buy,10/26/2012 1:00,0.81775,0.81779,($0.60),"$10,319.90 ",0.4,Neutral
298,10/26/2012 8:00,Sell,10/26/2012 8:00,0.82013,0.82148,($14.50),"$10,305.40 ",-13.5,Losing
299,11/1/2012 21:00,Sell,11/1/2012 21:00,0.82658,0.82696,($4.80),"$10,300.60 ",-3.8,Neutral
300,11/6/2012 7:00,Sell,11/6/2012 7:00,0.82768,0.82783,($2.50),"$10,298.10 ",-1.5,Neutral
301,11/6/2012 11:00,Buy,11/6/2012 11:00,0.82656,0.82746,$8.00 ,"$10,306.10 ",9,Winning
302,11/7/2012 21:00,Buy,11/7/2012 21:00,0.81736,0.81744,($0.20),"$10,305.90 ",0.8,Neutral
303,11/11/2012 17:00,Buy,11/11/2012 17:00,0.814,0.81463,$5.30 ,"$10,311.20 ",6.3,Winning
304,11/12/2012 21:00,Buy,11/12/2012 21:00,0.81657,0.81688,$2.10 ,"$10,313.30 ",3.1,Neutral
305,11/14/2012 23:00,Sell,11/14/2012 23:00,0.8123,0.81191,$2.90 ,"$10,316.20 ",3.9,Neutral
306,11/20/2012 4:00,Buy,11/20/2012 4:00,0.81697,0.81652,($5.50),"$10,310.70 ",-4.5,Neutral
307,11/20/2012 8:00,Buy,11/20/2012 8:00,0.81608,0.81624,$0.60 ,"$10,311.30 ",1.6,Neutral
308,11/20/2012 11:00,Buy,11/20/2012 11:00,0.81504,0.81517,$0.30 ,"$10,311.60 ",1.3,Neutral
309,11/21/2012 12:00,Buy,11/21/2012 12:00,0.81147,0.81263,$10.60 ,"$10,322.20 ",11.6,Winning
310,11/21/2012 15:00,Sell,11/21/2012 15:00,0.8136,0.8135,$0.00 ,"$10,322.20 ",1,Neutral
311,11/23/2012 13:00,Sell,11/23/2012 13:00,0.82476,0.82428,$3.80 ,"$10,326.00 ",4.8,Neutral
312,11/25/2012 17:00,Buy,11/25/2012 17:00,0.82329,0.82397,$5.80 ,"$10,331.80 ",6.8,Winning
313,11/26/2012 4:00,Buy,11/26/2012 4:00,0.82288,0.82254,($4.40),"$10,327.40 ",-3.4,Neutral
314,11/26/2012 8:00,Buy,11/26/2012 8:00,0.82198,0.82276,$6.80 ,"$10,334.20 ",7.8,Winning
315,11/27/2012 23:00,Sell,11/27/2012 23:00,0.82122,0.82151,($3.90),"$10,330.30 ",-2.9,Neutral
316,11/28/2012 9:00,Buy,11/28/2012 9:00,0.81965,0.8206,$8.50 ,"$10,338.80 ",9.5,Winning
317,11/28/2012 13:00,Sell,11/28/2012 13:00,0.82359,0.82347,$0.20 ,"$10,339.00 ",1.2,Neutral
318,11/28/2012 15:00,Sell,11/28/2012 15:00,0.82352,0.82372,($3.00),"$10,336.00 ",-2,Neutral
319,11/29/2012 9:00,Buy,11/29/2012 9:00,0.82303,0.82344,$3.10 ,"$10,339.10 ",4.1,Neutral
320,12/5/2012 3:00,Sell,12/5/2012 3:00,0.82555,0.82513,$3.20 ,"$10,342.30 ",4.2,Neutral
321,12/5/2012 18:00,Sell,12/5/2012 18:00,0.82916,0.82881,$2.50 ,"$10,344.80 ",3.5,Neutral
322,12/5/2012 23:00,Buy,12/5/2012 23:00,0.82875,0.82889,$0.40 ,"$10,345.20 ",1.4,Neutral
323,12/6/2012 13:00,Buy,12/6/2012 15:00,0.83122,0.83171,$3.90 ,"$10,349.10 ",4.9,Neutral
324,12/7/2012 8:00,Sell,12/7/2012 8:00,0.83222,0.83209,$0.30 ,"$10,349.40 ",1.3,Neutral
325,12/10/2012 4:00,Sell,12/10/2012 4:00,0.83288,0.83234,$4.40 ,"$10,353.80 ",5.4,Winning
326,12/10/2012 5:00,Buy,12/10/2012 5:00,0.83234,0.83302,$5.80 ,"$10,359.60 ",6.8,Winning
327,12/10/2012 15:00,Buy,12/10/2012 15:00,0.8337,0.83401,$2.10 ,"$10,361.70 ",3.1,Neutral
328,12/13/2012 11:00,Buy,12/13/2012 13:00,0.84407,0.8426,($15.70),"$10,346.00 ",-14.7,Losing
329,12/13/2012 22:00,Sell,12/13/2012 22:00,0.84359,0.84355,($0.60),"$10,345.40 ",0.4,Neutral
330,12/14/2012 11:00,Sell,12/14/2012 11:00,0.84325,0.84444,($12.90),"$10,332.50 ",-11.9,Losing
331,12/19/2012 6:00,Buy,12/19/2012 7:00,0.83714,0.83761,$3.70 ,"$10,336.20 ",4.7,Neutral
332,12/19/2012 21:00,Sell,12/19/2012 21:00,0.83416,0.8347,($6.40),"$10,329.80 ",-5.4,Losing
333,12/20/2012 3:00,Sell,12/20/2012 3:00,0.83622,0.83574,$3.80 ,"$10,333.60 ",4.8,Neutral
334,12/20/2012 11:00,Sell,12/20/2012 11:00,0.83293,0.83307,($2.40),"$10,331.20 ",-1.4,Neutral
335,12/21/2012 1:00,Buy,12/21/2012 3:00,0.83022,0.8283,($20.20),"$10,311.00 ",-19.2,Losing
336,12/21/2012 5:00,Buy,12/21/2012 7:00,0.8246,0.82412,($5.80),"$10,305.20 ",-4.8,Neutral
337,12/26/2012 0:00,Buy,12/26/2012 0:00,0.82124,0.82146,$1.20 ,"$10,306.40 ",2.2,Neutral
338,12/26/2012 5:00,Buy,12/26/2012 5:00,0.82107,0.82085,($3.20),"$10,303.20 ",-2.2,Neutral
339,12/26/2012 8:00,Buy,12/26/2012 9:00,0.81861,0.81852,($1.90),"$10,301.30 ",-0.9,Neutral
340,12/26/2012 10:00,Sell,12/26/2012 10:00,0.81852,0.81771,$7.10 ,"$10,308.40 ",8.1,Winning
341,12/26/2012 12:00,Buy,12/26/2012 12:00,0.81574,0.81624,$4.00 ,"$10,312.40 ",5,Neutral
342,12/26/2012 16:00,Sell,12/26/2012 16:00,0.81904,0.81943,($4.90),"$10,307.50 ",-3.9,Neutral
343,12/30/2012 20:00,Sell,12/30/2012 20:00,0.82361,0.82419,($6.80),"$10,300.70 ",-5.8,Losing
344,12/30/2012 22:00,Sell,12/30/2012 22:00,0.82421,0.82433,($2.20),"$10,298.50 ",-1.2,Neutral
345,1/2/2013 6:00,Buy,1/2/2013 6:00,0.83527,0.83563,$2.60 ,"$10,301.10 ",3.6,Neutral
346,1/2/2013 12:00,Buy,1/2/2013 13:00,0.83296,0.83009,($29.70),"$10,271.40 ",-28.7,Losing
347,1/2/2013 15:00,Buy,1/2/2013 15:00,0.83034,0.8329,$24.60 ,"$10,296.00 ",25.6,Winning
348,1/3/2013 22:00,Buy,1/3/2013 22:00,0.82329,0.82343,$0.40 ,"$10,296.40 ",1.4,Neutral
349,1/4/2013 10:00,Sell,1/4/2013 11:00,0.82823,0.82829,($1.60),"$10,294.80 ",-0.6,Neutral
350,1/6/2013 20:00,Buy,1/6/2013 20:00,0.83025,0.82998,($3.70),"$10,291.10 ",-2.7,Neutral
351,1/7/2013 21:00,Buy,1/7/2013 21:00,0.83641,0.83643,($0.80),"$10,290.30 ",0.2,Neutral
352,1/8/2013 2:00,Buy,1/8/2013 2:00,0.83502,0.83536,$2.40 ,"$10,292.70 ",3.4,Neutral
353,1/9/2013 5:00,Buy,1/9/2013 7:00,0.83699,0.83749,$4.00 ,"$10,296.70 ",5,Neutral
354,1/9/2013 15:00,Buy,1/9/2013 15:00,0.83847,0.83903,$4.60 ,"$10,301.30 ",5.6,Winning
355,1/10/2013 5:00,Sell,1/10/2013 6:00,0.84228,0.84367,($14.90),"$10,286.40 ",-13.9,Losing
356,1/10/2013 11:00,Buy,1/10/2013 11:00,0.84225,0.84233,($0.20),"$10,286.20 ",0.8,Neutral
357,1/10/2013 19:00,Buy,1/10/2013 19:00,0.84375,0.84367,($1.80),"$10,284.40 ",-0.8,Neutral
358,1/10/2013 21:00,Buy,1/10/2013 21:00,0.84248,0.84245,($1.30),"$10,283.10 ",-0.3,Neutral
359,1/11/2013 0:00,Sell,1/11/2013 0:00,0.84266,0.84241,$1.50 ,"$10,284.60 ",2.5,Neutral
360,1/11/2013 2:00,Buy,1/11/2013 2:00,0.84065,0.8414,$6.50 ,"$10,291.10 ",7.5,Winning
361,1/11/2013 5:00,Sell,1/11/2013 5:00,0.84113,0.83991,$11.20 ,"$10,302.30 ",12.2,Winning
362,1/11/2013 10:00,Buy,1/11/2013 10:00,0.83787,0.83879,$8.20 ,"$10,310.50 ",9.2,Winning
363,1/11/2013 15:00,Buy,1/11/2013 15:00,0.8364,0.83633,($1.70),"$10,308.80 ",-0.7,Neutral
364,1/13/2013 18:00,Buy,1/13/2013 18:00,0.8364,0.83661,$1.10 ,"$10,309.90 ",2.1,Neutral
365,1/14/2013 0:00,Sell,1/14/2013 0:00,0.84042,0.84023,$0.90 ,"$10,310.80 ",1.9,Neutral
366,1/20/2013 20:00,Buy,1/20/2013 20:00,0.83374,0.8353,$14.60 ,"$10,325.40 ",15.6,Winning
367,1/22/2013 1:00,Sell,1/22/2013 2:00,0.84111,0.84159,($5.80),"$10,319.60 ",-4.8,Neutral
368,1/22/2013 20:00,Sell,1/22/2013 20:00,0.84199,0.84087,$10.20 ,"$10,329.80 ",11.2,Winning
369,1/24/2013 22:00,Sell,1/24/2013 22:00,0.83666,0.83574,$8.20 ,"$10,338.00 ",9.2,Winning
370,1/24/2013 23:00,Buy,1/24/2013 23:00,0.83574,0.83591,$0.70 ,"$10,338.70 ",1.7,Neutral
371,1/28/2013 14:00,Sell,1/28/2013 15:00,0.83159,0.83293,($14.40),"$10,324.30 ",-13.4,Losing
372,1/29/2013 6:00,Buy,1/29/2013 6:00,0.83539,0.83585,$3.60 ,"$10,327.90 ",4.6,Neutral
373,1/29/2013 20:00,Buy,1/29/2013 20:00,0.83761,0.83768,($0.30),"$10,327.60 ",0.7,Neutral
374,1/29/2013 23:00,Buy,1/29/2013 23:00,0.83708,0.83696,($2.20),"$10,325.40 ",-1.2,Neutral
375,1/30/2013 4:00,Buy,1/30/2013 4:00,0.83493,0.83465,($3.80),"$10,321.60 ",-2.8,Neutral
376,1/30/2013 7:00,Buy,1/30/2013 7:00,0.8325,0.83229,($3.10),"$10,318.50 ",-2.1,Neutral
377,1/30/2013 10:00,Buy,1/30/2013 10:00,0.83069,0.83148,$6.90 ,"$10,325.40 ",7.9,Winning
378,1/31/2013 16:00,Buy,1/31/2013 17:00,0.83911,0.83935,$1.40 ,"$10,326.80 ",2.4,Neutral
379,2/1/2013 3:00,Sell,2/1/2013 4:00,0.84295,0.84014,$27.10 ,"$10,353.90 ",28.1,Winning
380,2/3/2013 20:00,Buy,2/3/2013 20:00,0.84475,0.84617,$13.20 ,"$10,367.10 ",14.2,Winning
381,2/5/2013 2:00,Sell,2/5/2013 2:00,0.84153,0.84281,($13.80),"$10,353.30 ",-12.8,Losing
382,2/6/2013 11:00,Sell,2/6/2013 11:00,0.84258,0.84263,($1.50),"$10,351.80 ",-0.5,Neutral
383,2/6/2013 17:00,Buy,2/6/2013 18:00,0.83878,0.83809,($7.90),"$10,343.90 ",-6.9,Losing
384,2/6/2013 21:00,Buy,2/6/2013 23:00,0.83668,0.83625,($5.30),"$10,338.60 ",-4.3,Neutral
385,2/7/2013 0:00,Sell,2/7/2013 0:00,0.83625,0.8371,($9.50),"$10,329.10 ",-8.5,Losing
386,2/7/2013 11:00,Buy,2/7/2013 12:00,0.83234,0.83135,($10.90),"$10,318.20 ",-9.9,Losing
387,2/11/2013 6:00,Sell,2/11/2013 6:00,0.83183,0.83213,($4.00),"$10,314.20 ",-3,Neutral
388,2/14/2013 12:00,Buy,2/14/2013 12:00,0.84696,0.84688,($1.80),"$10,312.40 ",-0.8,Neutral
389,2/15/2013 15:00,Buy,2/15/2013 15:00,0.84397,0.84453,$4.60 ,"$10,317.00 ",5.6,Winning
390,2/17/2013 14:00,Sell,2/17/2013 14:00,0.84395,0.84374,$1.10 ,"$10,318.10 ",2.1,Neutral
391,2/20/2013 2:00,Buy,2/20/2013 2:00,0.83952,0.84043,$8.10 ,"$10,326.20 ",9.1,Winning
392,2/25/2013 20:00,Sell,2/25/2013 20:00,0.83361,0.83408,($5.70),"$10,320.50 ",-4.7,Neutral
393,2/26/2013 6:00,Buy,2/26/2013 6:00,0.83075,0.82885,($20.00),"$10,300.50 ",-19,Losing
394,2/26/2013 8:00,Buy,2/26/2013 8:00,0.82795,0.82876,$7.10 ,"$10,307.60 ",8.1,Winning
395,2/26/2013 11:00,Sell,2/26/2013 11:00,0.8249,0.82454,$2.60 ,"$10,310.20 ",3.6,Neutral
396,2/28/2013 9:00,Buy,2/28/2013 9:00,0.82966,0.82975,($0.10),"$10,310.10 ",0.9,Neutral
397,3/4/2013 1:00,Buy,3/4/2013 2:00,0.81969,0.82029,$5.00 ,"$10,315.10 ",6,Winning
398,3/5/2013 6:00,Buy,3/5/2013 6:00,0.82605,0.8264,$2.50 ,"$10,317.60 ",3.5,Neutral
399,3/6/2013 2:00,Buy,3/6/2013 4:00,0.83246,0.831,($15.60),"$10,302.00 ",-14.6,Losing
400,3/6/2013 6:00,Sell,3/6/2013 6:00,0.83155,0.83174,($2.90),"$10,299.10 ",-1.9,Neutral
401,3/6/2013 11:00,Buy,3/6/2013 14:00,0.83139,0.82936,($21.30),"$10,277.80 ",-20.3,Losing
402,3/6/2013 15:00,Sell,3/6/2013 16:00,0.82936,0.8282,$10.60 ,"$10,288.40 ",11.6,Winning
403,3/6/2013 23:00,Sell,3/6/2013 23:00,0.82783,0.82747,$2.60 ,"$10,291.00 ",3.6,Neutral
404,3/10/2013 22:00,Sell,3/10/2013 22:00,0.82212,0.82203,($0.10),"$10,290.90 ",0.9,Neutral
405,3/11/2013 20:00,Buy,3/11/2013 20:00,0.8254,0.82519,($3.10),"$10,287.80 ",-2.1,Neutral
406,3/12/2013 0:00,Buy,3/12/2013 0:00,0.82428,0.82495,$5.70 ,"$10,293.50 ",6.7,Winning
407,3/12/2013 5:00,Sell,3/12/2013 5:00,0.82385,0.82377,($0.20),"$10,293.30 ",0.8,Neutral
408,3/12/2013 10:00,Sell,3/12/2013 10:00,0.82614,0.82531,$7.30 ,"$10,300.60 ",8.3,Winning
409,3/17/2013 15:00,Buy,3/17/2013 15:00,0.82191,0.82148,($5.30),"$10,295.30 ",-4.3,Neutral
410,3/17/2013 20:00,Sell,3/17/2013 20:00,0.82237,0.82266,($3.90),"$10,291.40 ",-2.9,Neutral
411,3/21/2013 3:00,Buy,3/21/2013 3:00,0.82562,0.82641,$6.90 ,"$10,298.30 ",7.9,Winning
412,3/22/2013 10:00,Sell,3/22/2013 10:00,0.83147,0.83303,($16.60),"$10,281.70 ",-15.6,Losing
413,3/25/2013 4:00,Sell,3/25/2013 4:00,0.83453,0.8348,($3.70),"$10,278.00 ",-2.7,Neutral
414,3/26/2013 19:00,Sell,3/26/2013 19:00,0.83941,0.83861,$7.00 ,"$10,285.00 ",8,Winning
415,4/2/2013 6:00,Sell,4/2/2013 6:00,0.84153,0.84276,($13.30),"$10,271.70 ",-12.3,Losing
416,4/2/2013 13:00,Buy,4/2/2013 15:00,0.84159,0.8418,$1.10 ,"$10,272.80 ",2.1,Neutral
417,4/2/2013 21:00,Buy,4/2/2013 22:00,0.84053,0.84019,($4.40),"$10,268.40 ",-3.4,Neutral
418,4/3/2013 0:00,Sell,4/3/2013 0:00,0.84029,0.84052,($3.30),"$10,265.10 ",-2.3,Neutral
419,4/3/2013 2:00,Sell,4/3/2013 4:00,0.84096,0.84229,($14.30),"$10,250.80 ",-13.3,Losing
420,4/3/2013 9:00,Sell,4/3/2013 9:00,0.84417,0.84449,($4.20),"$10,246.60 ",-3.2,Neutral
421,4/3/2013 14:00,Buy,4/3/2013 15:00,0.842,0.84173,($3.70),"$10,242.90 ",-2.7,Neutral
422,4/3/2013 21:00,Sell,4/3/2013 21:00,0.84167,0.84167,($1.00),"$10,241.90 ",0,Neutral
423,4/8/2013 10:00,Sell,4/8/2013 10:00,0.8472,0.84524,$18.60 ,"$10,260.50 ",19.6,Winning
424,4/16/2013 5:00,Buy,4/16/2013 5:00,0.84489,0.84688,$18.90 ,"$10,279.40 ",19.9,Winning
425,4/18/2013 18:00,Sell,4/18/2013 18:00,0.84102,0.84146,($5.40),"$10,274.00 ",-4.4,Neutral
426,4/19/2013 4:00,Sell,4/19/2013 4:00,0.84671,0.84759,($9.80),"$10,264.20 ",-8.8,Losing
427,4/23/2013 3:00,Sell,4/23/2013 3:00,0.83707,0.83698,($0.10),"$10,264.10 ",0.9,Neutral
428,4/24/2013 23:00,Sell,4/24/2013 23:00,0.85305,0.85353,($5.80),"$10,258.30 ",-4.8,Neutral
429,4/25/2013 4:00,Buy,4/25/2013 4:00,0.85206,0.85428,$21.20 ,"$10,279.50 ",22.2,Winning
430,4/29/2013 15:00,Sell,4/29/2013 15:00,0.85721,0.85661,$5.00 ,"$10,284.50 ",6,Winning
431,4/29/2013 19:00,Buy,4/29/2013 20:00,0.85451,0.85529,$6.80 ,"$10,291.30 ",7.8,Winning
432,5/1/2013 12:00,Buy,5/1/2013 14:00,0.84911,0.85117,$19.60 ,"$10,310.90 ",20.6,Winning
433,5/1/2013 22:00,Buy,5/1/2013 22:00,0.84822,0.8493,$9.80 ,"$10,320.70 ",10.8,Winning
434,5/2/2013 9:00,Buy,5/2/2013 9:00,0.84657,0.84751,$8.40 ,"$10,329.10 ",9.4,Winning
435,5/7/2013 8:00,Buy,5/7/2013 9:00,0.84542,0.84465,($8.70),"$10,320.40 ",-7.7,Losing
436,5/9/2013 5:00,Buy,5/9/2013 5:00,0.84434,0.84537,$9.30 ,"$10,329.70 ",10.3,Winning
437,5/10/2013 5:00,Buy,5/10/2013 5:00,0.83297,0.83458,$15.10 ,"$10,344.80 ",16.1,Winning
438,5/13/2013 12:00,Buy,5/13/2013 12:00,0.82433,0.82395,($4.80),"$10,340.00 ",-3.8,Neutral
439,5/14/2013 10:00,Sell,5/14/2013 11:00,0.82352,0.82122,$22.00 ,"$10,362.00 ",23,Winning
440,5/15/2013 3:00,Buy,5/15/2013 3:00,0.81906,0.81947,$3.10 ,"$10,365.10 ",4.1,Neutral
441,5/16/2013 8:00,Sell,5/16/2013 8:00,0.81579,0.81865,($29.60),"$10,335.50 ",-28.6,Losing
442,5/17/2013 10:00,Buy,5/17/2013 10:00,0.80706,0.80704,($1.20),"$10,334.30 ",-0.2,Neutral
443,5/20/2013 8:00,Sell,5/20/2013 8:00,0.81576,0.81493,$7.30 ,"$10,341.60 ",8.3,Winning
444,5/20/2013 21:00,Buy,5/20/2013 21:00,0.81418,0.8163,$20.20 ,"$10,361.80 ",21.2,Winning
445,5/21/2013 11:00,Sell,5/21/2013 11:00,0.81332,0.81605,($28.30),"$10,333.50 ",-27.3,Losing
446,5/23/2013 17:00,Buy,5/23/2013 18:00,0.81313,0.81128,($19.50),"$10,314.00 ",-18.5,Losing
447,5/24/2013 0:00,Sell,5/24/2013 0:00,0.80815,0.81009,($20.40),"$10,293.60 ",-19.4,Losing
448,5/29/2013 17:00,Buy,5/29/2013 17:00,0.8093,0.81004,$6.40 ,"$10,300.00 ",7.4,Winning
449,5/29/2013 19:00,Buy,5/29/2013 19:00,0.8085,0.81053,$19.30 ,"$10,319.30 ",20.3,Winning
450,5/31/2013 9:00,Sell,5/31/2013 9:00,0.79905,0.79576,$31.90 ,"$10,351.20 ",32.9,Winning
451,5/31/2013 13:00,Sell,5/31/2013 13:00,0.79608,0.79623,($2.50),"$10,348.70 ",-1.5,Neutral
452,5/31/2013 15:00,Buy,5/31/2013 15:00,0.79392,0.79448,$4.60 ,"$10,353.30 ",5.6,Winning
453,6/3/2013 3:00,Sell,6/3/2013 3:00,0.79772,0.79656,$10.60 ,"$10,363.90 ",11.6,Winning
454,6/3/2013 22:00,Buy,6/3/2013 22:00,0.80707,0.80496,($22.10),"$10,341.80 ",-21.1,Losing
455,6/4/2013 0:00,Buy,6/4/2013 0:00,0.80438,0.80541,$9.30 ,"$10,351.10 ",10.3,Winning
456,6/4/2013 3:00,Sell,6/4/2013 3:00,0.80325,0.80185,$13.00 ,"$10,364.10 ",14,Winning
457,6/4/2013 16:00,Sell,6/4/2013 16:00,0.80065,0.80126,($7.10),"$10,357.00 ",-6.1,Losing
458,6/6/2013 18:00,Buy,6/6/2013 19:00,0.7981,0.79987,$16.70 ,"$10,373.70 ",17.7,Winning
459,6/9/2013 15:00,Sell,6/9/2013 15:00,0.78759,0.78369,$38.00 ,"$10,411.70 ",39,Winning
460,6/10/2013 0:00,Buy,6/10/2013 1:00,0.78369,0.78539,$16.00 ,"$10,427.70 ",17,Winning
461,6/10/2013 4:00,Sell,6/10/2013 4:00,0.78711,0.78736,($3.50),"$10,424.20 ",-2.5,Neutral
462,6/11/2013 10:00,Sell,6/11/2013 10:00,0.78226,0.78526,($31.00),"$10,393.20 ",-30,Losing
463,6/12/2013 16:00,Buy,6/12/2013 16:00,0.79575,0.79746,$16.10 ,"$10,409.30 ",17.1,Winning
464,6/13/2013 21:00,Buy,6/13/2013 21:00,0.80529,0.80667,$12.80 ,"$10,422.10 ",13.8,Winning
465,6/14/2013 0:00,Buy,6/14/2013 0:00,0.80524,0.80593,$5.90 ,"$10,428.00 ",6.9,Winning
466,6/14/2013 12:00,Buy,6/14/2013 13:00,0.8062,0.80551,($7.90),"$10,420.10 ",-6.9,Losing
467,6/14/2013 16:00,Sell,6/14/2013 16:00,0.80578,0.80396,$17.20 ,"$10,437.30 ",18.2,Winning
468,6/17/2013 6:00,Buy,6/17/2013 6:00,0.80768,0.80821,$4.30 ,"$10,441.60 ",5.3,Winning
469,6/17/2013 8:00,Buy,6/17/2013 8:00,0.80723,0.80636,($9.70),"$10,431.90 ",-8.7,Losing
470,6/17/2013 14:00,Buy,6/17/2013 15:00,0.79925,0.8005,$11.50 ,"$10,443.40 ",12.5,Winning
471,6/18/2013 17:00,Buy,6/18/2013 17:00,0.79792,0.7991,$10.80 ,"$10,454.20 ",11.8,Winning
472,6/19/2013 19:00,Buy,6/19/2013 19:00,0.78579,0.78687,$9.80 ,"$10,464.00 ",10.8,Winning
473,6/20/2013 0:00,Buy,6/20/2013 1:00,0.78506,0.78416,($10.00),"$10,454.00 ",-9,Losing
474,6/20/2013 4:00,Buy,6/20/2013 4:00,0.77993,0.7803,$2.70 ,"$10,456.70 ",3.7,Neutral
475,6/21/2013 5:00,Sell,6/21/2013 5:00,0.77741,0.77808,($7.70),"$10,449.00 ",-6.7,Losing
476,6/21/2013 7:00,Buy,6/21/2013 7:00,0.77613,0.77642,$1.90 ,"$10,450.90 ",2.9,Neutral
477,6/21/2013 15:00,Sell,6/21/2013 15:00,0.77705,0.77576,$11.90 ,"$10,462.80 ",12.9,Winning
478,6/26/2013 17:00,Sell,6/26/2013 18:00,0.77815,0.7776,$4.50 ,"$10,467.30 ",5.5,Winning
479,6/27/2013 11:00,Buy,6/27/2013 11:00,0.77843,0.77831,($2.20),"$10,465.10 ",-1.2,Neutral
480,6/30/2013 17:00,Buy,6/30/2013 17:00,0.77075,0.77327,$24.20 ,"$10,489.30 ",25.2,Winning
481,6/30/2013 22:00,Sell,6/30/2013 22:00,0.77689,0.77578,$10.10 ,"$10,499.40 ",11.1,Winning
482,7/2/2013 12:00,Sell,7/2/2013 12:00,0.77574,0.77555,$0.90 ,"$10,500.30 ",1.9,Neutral
483,7/3/2013 3:00,Buy,7/3/2013 3:00,0.77157,0.77266,$9.90 ,"$10,510.20 ",10.9,Winning
484,7/4/2013 11:00,Sell,7/4/2013 11:00,0.7854,0.78508,$2.20 ,"$10,512.40 ",3.2,Neutral
485,7/4/2013 17:00,Buy,7/4/2013 17:00,0.78283,0.78266,($2.70),"$10,509.70 ",-1.7,Neutral
486,7/5/2013 11:00,Buy,7/5/2013 11:00,0.76966,0.77083,$10.70 ,"$10,520.40 ",11.7,Winning
487,7/5/2013 13:00,Buy,7/5/2013 14:00,0.77026,0.77069,$3.30 ,"$10,523.70 ",4.3,Neutral
488,7/8/2013 10:00,Sell,7/8/2013 10:00,0.7788,0.78084,($21.40),"$10,502.30 ",-20.4,Losing
489,7/8/2013 17:00,Buy,7/8/2013 17:00,0.77968,0.78034,$5.60 ,"$10,507.90 ",6.6,Winning
490,7/8/2013 20:00,Buy,7/8/2013 20:00,0.77852,0.77862,$0.00 ,"$10,507.90 ",1,Neutral
491,7/9/2013 0:00,Sell,7/9/2013 0:00,0.78039,0.78022,$0.70 ,"$10,508.60 ",1.7,Neutral
492,7/9/2013 3:00,Sell,7/9/2013 3:00,0.78526,0.7858,($6.40),"$10,502.20 ",-5.4,Losing
493,7/9/2013 19:00,Buy,7/9/2013 20:00,0.78325,0.7833,($0.50),"$10,501.70 ",0.5,Neutral
494,7/9/2013 22:00,Sell,7/9/2013 22:00,0.78375,0.7828,$8.50 ,"$10,510.20 ",9.5,Winning
495,7/10/2013 18:00,Sell,7/10/2013 18:00,0.78986,0.79466,($49.00),"$10,461.20 ",-48,Losing
496,7/11/2013 4:00,Buy,7/11/2013 6:00,0.78971,0.7874,($24.10),"$10,437.10 ",-23.1,Losing
497,7/11/2013 8:00,Buy,7/11/2013 8:00,0.78609,0.78424,($19.50),"$10,417.60 ",-18.5,Losing
498,7/11/2013 9:00,Sell,7/11/2013 9:00,0.78424,0.78374,$4.00 ,"$10,421.60 ",5,Winning
499,7/11/2013 11:00,Buy,7/11/2013 11:00,0.78151,0.77978,($18.30),"$10,403.30 ",-17.3,Losing
500,7/17/2013 22:00,Buy,7/17/2013 23:00,0.78726,0.78653,($8.30),"$10,395.00 ",-7.3,Losing
501,7/22/2013 22:00,Sell,7/22/2013 22:00,0.79978,0.79982,($1.40),"$10,393.60 ",-0.4,Neutral
502,7/25/2013 20:00,Buy,7/25/2013 20:00,0.80589,0.80654,$5.50 ,"$10,399.10 ",6.5,Winning
503,7/26/2013 8:00,Buy,7/26/2013 9:00,0.80624,0.80799,$16.50 ,"$10,415.60 ",17.5,Winning
504,7/26/2013 11:00,Buy,7/26/2013 11:00,0.80588,0.80693,$9.50 ,"$10,425.10 ",10.5,Winning
505,7/28/2013 17:00,Buy,7/28/2013 17:00,0.80672,0.80718,$3.60 ,"$10,428.70 ",4.6,Neutral
506,7/29/2013 2:00,Buy,7/29/2013 2:00,0.80767,0.80688,($8.90),"$10,419.80 ",-7.9,Losing
507,7/29/2013 14:00,Buy,7/29/2013 14:00,0.80163,0.80241,$6.80 ,"$10,426.60 ",7.8,Winning
508,7/30/2013 0:00,Buy,7/30/2013 0:00,0.79863,0.79939,$6.60 ,"$10,433.20 ",7.6,Winning
509,7/30/2013 6:00,Buy,7/30/2013 6:00,0.79817,0.79887,$6.00 ,"$10,439.20 ",7,Winning
510,7/31/2013 10:00,Buy,7/31/2013 10:00,0.79342,0.79584,$23.20 ,"$10,462.40 ",24.2,Winning
511,7/31/2013 15:00,Sell,7/31/2013 15:00,0.80114,0.79859,$24.50 ,"$10,486.90 ",25.5,Winning
512,8/1/2013 11:00,Buy,8/1/2013 11:00,0.78628,0.78657,$1.90 ,"$10,488.80 ",2.9,Neutral
513,8/1/2013 13:00,Sell,8/1/2013 13:00,0.78785,0.78822,($4.70),"$10,484.10 ",-3.7,Neutral
514,8/2/2013 4:00,Buy,8/2/2013 4:00,0.78713,0.78598,($12.50),"$10,471.60 ",-11.5,Losing
515,8/2/2013 11:00,Buy,8/2/2013 12:00,0.78351,0.78503,$14.20 ,"$10,485.80 ",15.2,Winning
516,8/5/2013 3:00,Sell,8/5/2013 3:00,0.77959,0.78063,($11.40),"$10,474.40 ",-10.4,Losing
517,8/5/2013 7:00,Buy,8/5/2013 7:00,0.77647,0.77605,($5.20),"$10,469.20 ",-4.2,Neutral
518,8/5/2013 13:00,Sell,8/5/2013 13:00,0.7802,0.78044,($3.40),"$10,465.80 ",-2.4,Neutral
519,8/6/2013 9:00,Buy,8/6/2013 9:00,0.78602,0.78707,$9.50 ,"$10,475.30 ",10.5,Winning
520,8/6/2013 23:00,Buy,8/6/2013 23:00,0.78891,0.78949,$4.80 ,"$10,480.10 ",5.8,Winning
521,8/7/2013 2:00,Sell,8/7/2013 3:00,0.79035,0.78931,$9.40 ,"$10,489.50 ",10.4,Winning
522,8/7/2013 10:00,Sell,8/7/2013 11:00,0.7956,0.7975,($20.00),"$10,469.50 ",-19,Losing
523,8/7/2013 16:00,Buy,8/7/2013 16:00,0.79595,0.79666,$6.10 ,"$10,475.60 ",7.1,Winning
524,8/11/2013 15:00,Buy,8/11/2013 15:00,0.80248,0.80347,$8.90 ,"$10,484.50 ",9.9,Winning
525,8/11/2013 20:00,Sell,8/11/2013 20:00,0.80232,0.80311,($8.90),"$10,475.60 ",-7.9,Losing
526,8/12/2013 3:00,Buy,8/12/2013 4:00,0.80114,0.80061,($6.30),"$10,469.30 ",-5.3,Losing
527,8/12/2013 6:00,Sell,8/12/2013 7:00,0.80064,0.80035,$1.90 ,"$10,471.20 ",2.9,Neutral
528,8/14/2013 17:00,Buy,8/14/2013 17:00,0.80248,0.80297,$3.90 ,"$10,475.10 ",4.9,Neutral
529,8/20/2013 0:00,Buy,8/20/2013 1:00,0.79901,0.7987,($4.10),"$10,471.00 ",-3.1,Neutral
530,8/20/2013 3:00,Buy,8/20/2013 3:00,0.79659,0.79686,$1.70 ,"$10,472.70 ",2.7,Neutral
531,8/20/2013 11:00,Buy,8/20/2013 11:00,0.79729,0.79855,$11.60 ,"$10,484.30 ",12.6,Winning
532,8/20/2013 17:00,Buy,8/20/2013 17:00,0.7976,0.79589,($18.10),"$10,466.20 ",-17.1,Losing
533,8/22/2013 6:00,Buy,8/22/2013 6:00,0.78113,0.78115,($0.80),"$10,465.40 ",0.2,Neutral
534,8/22/2013 15:00,Buy,8/22/2013 15:00,0.78216,0.78311,$8.50 ,"$10,473.90 ",9.5,Winning
535,8/27/2013 1:00,Sell,8/27/2013 1:00,0.78146,0.78117,$1.90 ,"$10,475.80 ",2.9,Neutral
536,8/28/2013 1:00,Buy,8/28/2013 1:00,0.77582,0.77753,$16.10 ,"$10,491.90 ",17.1,Winning
537,8/28/2013 10:00,Sell,8/28/2013 11:00,0.77498,0.78,($51.20),"$10,440.70 ",-50.2,Losing
538,8/29/2013 4:00,Buy,8/29/2013 4:00,0.77937,0.7791,($3.70),"$10,437.00 ",-2.7,Neutral
539,8/29/2013 9:00,Sell,8/29/2013 9:00,0.7766,0.77804,($15.40),"$10,421.60 ",-14.4,Losing
540,8/30/2013 0:00,Sell,8/30/2013 0:00,0.77803,0.77727,$6.60 ,"$10,428.20 ",7.6,Winning
541,8/30/2013 12:00,Buy,8/30/2013 12:00,0.77259,0.77347,$7.80 ,"$10,436.00 ",8.8,Winning
542,8/30/2013 14:00,Sell,8/30/2013 15:00,0.77335,0.77269,$5.60 ,"$10,441.60 ",6.6,Winning
543,9/2/2013 12:00,Buy,9/2/2013 12:00,0.77999,0.77939,($7.00),"$10,434.60 ",-6,Losing
544,9/3/2013 5:00,Buy,9/3/2013 5:00,0.78052,0.78099,$3.70 ,"$10,438.30 ",4.7,Neutral
545,9/3/2013 8:00,Buy,9/3/2013 8:00,0.78046,0.77967,($8.90),"$10,429.40 ",-7.9,Losing
546,9/3/2013 15:00,Sell,9/3/2013 15:00,0.77919,0.77939,($3.00),"$10,426.40 ",-2,Neutral
547,9/4/2013 6:00,Sell,9/4/2013 6:00,0.7877,0.78882,($12.20),"$10,414.20 ",-11.2,Losing
548,9/9/2013 4:00,Sell,9/9/2013 4:00,0.80052,0.801,($5.80),"$10,408.40 ",-4.8,Neutral
549,9/10/2013 0:00,Sell,9/10/2013 0:00,0.80463,0.80453,$0.00 ,"$10,408.40 ",1,Neutral
550,9/10/2013 3:00,Buy,9/10/2013 3:00,0.80193,0.80144,($5.90),"$10,402.50 ",-4.9,Neutral
551,9/10/2013 8:00,Sell,9/10/2013 8:00,0.80534,0.80509,$1.50 ,"$10,404.00 ",2.5,Neutral
552,9/10/2013 19:00,Buy,9/10/2013 20:00,0.80527,0.80582,$4.50 ,"$10,408.50 ",5.5,Winning
553,9/10/2013 22:00,Buy,9/10/2013 22:00,0.80468,0.80529,$5.10 ,"$10,413.60 ",6.1,Winning
554,9/11/2013 5:00,Sell,9/11/2013 5:00,0.80772,0.80681,$8.10 ,"$10,421.70 ",9.1,Winning
555,9/11/2013 21:00,Sell,9/11/2013 21:00,0.8148,0.81196,$27.40 ,"$10,449.10 ",28.4,Winning
556,9/13/2013 4:00,Sell,9/13/2013 4:00,0.81178,0.81229,($6.10),"$10,443.00 ",-5.1,Losing
557,9/16/2013 11:00,Buy,9/16/2013 13:00,0.81821,0.81744,($8.70),"$10,434.30 ",-7.7,Losing
558,9/16/2013 16:00,Sell,9/16/2013 16:00,0.81649,0.8168,($4.10),"$10,430.20 ",-3.1,Neutral
559,9/17/2013 17:00,Buy,9/17/2013 17:00,0.82353,0.82307,($5.60),"$10,424.60 ",-4.6,Neutral
560,9/17/2013 20:00,Buy,9/17/2013 20:00,0.82241,0.82189,($6.20),"$10,418.40 ",-5.2,Losing
561,9/18/2013 1:00,Sell,9/18/2013 1:00,0.82265,0.82224,$3.10 ,"$10,421.50 ",4.1,Neutral
562,9/19/2013 12:00,Buy,9/19/2013 12:00,0.8359,0.83662,$6.20 ,"$10,427.70 ",7.2,Winning
563,9/19/2013 14:00,Buy,9/19/2013 14:00,0.83537,0.83678,$13.10 ,"$10,440.80 ",14.1,Winning
564,9/19/2013 15:00,Sell,9/19/2013 15:00,0.83678,0.83756,($8.80),"$10,432.00 ",-7.8,Losing
565,9/19/2013 18:00,Sell,9/19/2013 18:00,0.83786,0.83823,($4.70),"$10,427.30 ",-3.7,Neutral
566,9/20/2013 0:00,Buy,9/20/2013 0:00,0.83753,0.83803,$4.00 ,"$10,431.30 ",5,Winning
567,9/20/2013 2:00,Sell,9/20/2013 2:00,0.83888,0.83874,$0.40 ,"$10,431.70 ",1.4,Neutral
568,9/20/2013 8:00,Buy,9/20/2013 8:00,0.83782,0.83637,($15.50),"$10,416.20 ",-14.5,Losing
569,9/20/2013 12:00,Sell,9/20/2013 12:00,0.83689,0.8381,($13.10),"$10,403.10 ",-12.1,Losing
570,9/24/2013 6:00,Buy,9/24/2013 7:00,0.82773,0.82892,$10.90 ,"$10,414.00 ",11.9,Winning
571,9/24/2013 8:00,Sell,9/24/2013 8:00,0.82892,0.82924,($4.20),"$10,409.80 ",-3.2,Neutral
572,9/24/2013 10:00,Sell,9/24/2013 10:00,0.82749,0.82784,($4.50),"$10,405.30 ",-3.5,Neutral
573,9/24/2013 16:00,Buy,9/24/2013 16:00,0.82695,0.82785,$8.00 ,"$10,413.30 ",9,Winning
574,9/24/2013 23:00,Buy,9/24/2013 23:00,0.82382,0.8222,($17.20),"$10,396.10 ",-16.2,Losing
575,9/25/2013 17:00,Buy,9/25/2013 17:00,0.82392,0.82408,$0.60 ,"$10,396.70 ",1.6,Neutral
576,9/26/2013 3:00,Sell,9/26/2013 5:00,0.82847,0.82869,($3.20),"$10,393.50 ",-2.2,Neutral
577,9/26/2013 17:00,Sell,9/26/2013 17:00,0.82896,0.82869,$1.70 ,"$10,395.20 ",2.7,Neutral
578,10/3/2013 3:00,Sell,10/3/2013 3:00,0.8333,0.8318,$14.00 ,"$10,409.20 ",15,Winning
579,10/3/2013 5:00,Buy,10/3/2013 7:00,0.83007,0.82868,($14.90),"$10,394.30 ",-13.9,Losing
580,10/3/2013 9:00,Sell,10/3/2013 9:00,0.82889,0.82869,$1.00 ,"$10,395.30 ",2,Neutral
581,10/6/2013 14:00,Buy,10/6/2013 15:00,0.83069,0.83137,$5.80 ,"$10,401.10 ",6.8,Winning
582,10/6/2013 17:00,Buy,10/6/2013 17:00,0.83062,0.83167,$9.50 ,"$10,410.60 ",10.5,Winning
583,10/6/2013 23:00,Buy,10/7/2013 0:00,0.82971,0.82906,($7.50),"$10,403.10 ",-6.5,Losing
584,10/10/2013 6:00,Sell,10/10/2013 7:00,0.82585,0.82579,($0.40),"$10,402.70 ",0.6,Neutral
585,10/10/2013 9:00,Buy,10/10/2013 9:00,0.82409,0.82721,$30.20 ,"$10,432.90 ",31.2,Winning
586,10/11/2013 11:00,Buy,10/11/2013 11:00,0.83164,0.83313,$13.90 ,"$10,446.80 ",14.9,Winning
587,10/11/2013 13:00,Sell,10/11/2013 13:00,0.83256,0.83229,$1.70 ,"$10,448.50 ",2.7,Neutral
588,10/14/2013 11:00,Buy,10/14/2013 11:00,0.83559,0.8358,$1.10 ,"$10,449.60 ",2.1,Neutral
589,10/14/2013 17:00,Buy,10/14/2013 17:00,0.83538,0.83561,$1.30 ,"$10,450.90 ",2.3,Neutral
590,10/14/2013 21:00,Sell,10/14/2013 21:00,0.83799,0.83733,$5.60 ,"$10,456.50 ",6.6,Winning
591,10/16/2013 9:00,Buy,10/16/2013 9:00,0.84064,0.84232,$15.80 ,"$10,472.30 ",16.8,Winning
592,10/17/2013 7:00,Sell,10/17/2013 7:00,0.8482,0.84939,($12.90),"$10,459.40 ",-11.9,Losing
593,10/17/2013 15:00,Buy,10/17/2013 17:00,0.85021,0.8477,($26.10),"$10,433.30 ",-25.1,Losing
594,10/17/2013 19:00,Buy,10/17/2013 20:00,0.84574,0.84625,$4.10 ,"$10,437.40 ",5.1,Winning
595,10/22/2013 3:00,Sell,10/22/2013 3:00,0.84573,0.84482,$8.10 ,"$10,445.50 ",9.1,Winning
596,10/23/2013 2:00,Sell,10/23/2013 2:00,0.84185,0.84104,$7.10 ,"$10,452.60 ",8.1,Winning
597,10/23/2013 4:00,Buy,10/23/2013 4:00,0.83954,0.8387,($9.40),"$10,443.20 ",-8.4,Losing
598,10/23/2013 7:00,Buy,10/23/2013 7:00,0.83771,0.83671,($11.00),"$10,432.20 ",-10,Losing
599,10/24/2013 5:00,Buy,10/24/2013 5:00,0.83699,0.83707,($0.20),"$10,432.00 ",0.8,Neutral
600,10/24/2013 7:00,Buy,10/24/2013 7:00,0.83566,0.8365,$7.40 ,"$10,439.40 ",8.4,Winning
601,10/24/2013 9:00,Buy,10/24/2013 10:00,0.8332,0.83413,$8.30 ,"$10,447.70 ",9.3,Winning
602,10/24/2013 18:00,Buy,10/24/2013 18:00,0.83399,0.83351,($5.80),"$10,441.90 ",-4.8,Neutral
603,10/25/2013 4:00,Buy,10/25/2013 5:00,0.83067,0.8306,($1.70),"$10,440.20 ",-0.7,Neutral
604,10/25/2013 12:00,Buy,10/25/2013 12:00,0.8279,0.82819,$1.90 ,"$10,442.10 ",2.9,Neutral
605,10/27/2013 14:00,Buy,10/27/2013 14:00,0.8268,0.82762,$7.20 ,"$10,449.30 ",8.2,Winning
606,10/27/2013 22:00,Sell,10/27/2013 22:00,0.83039,0.83061,($3.20),"$10,446.10 ",-2.2,Neutral
607,10/28/2013 6:00,Sell,10/28/2013 6:00,0.83201,0.83232,($4.10),"$10,442.00 ",-3.1,Neutral
608,10/29/2013 4:00,Buy,10/29/2013 4:00,0.82588,0.82508,($9.00),"$10,433.00 ",-8,Losing
609,10/29/2013 8:00,Buy,10/29/2013 8:00,0.82477,0.82572,$8.50 ,"$10,441.50 ",9.5,Winning
610,10/29/2013 14:00,Buy,10/29/2013 14:00,0.82386,0.82501,$10.50 ,"$10,452.00 ",11.5,Winning
611,11/6/2013 9:00,Buy,11/6/2013 9:00,0.83925,0.84018,$8.30 ,"$10,460.30 ",9.3,Winning
612,11/6/2013 11:00,Buy,11/6/2013 11:00,0.83898,0.83794,($11.40),"$10,448.90 ",-10.4,Losing
613,11/6/2013 14:00,Buy,11/6/2013 14:00,0.83792,0.83919,$11.70 ,"$10,460.60 ",12.7,Winning
614,11/6/2013 17:00,Buy,11/6/2013 17:00,0.83753,0.83737,($2.60),"$10,458.00 ",-1.6,Neutral
615,11/6/2013 19:00,Buy,11/6/2013 19:00,0.83731,0.83676,($6.50),"$10,451.50 ",-5.5,Losing
616,11/6/2013 21:00,Buy,11/6/2013 22:00,0.83547,0.83558,$0.10 ,"$10,451.60 ",1.1,Neutral
617,11/7/2013 3:00,Sell,11/7/2013 3:00,0.8377,0.83762,($0.20),"$10,451.40 ",0.8,Neutral
618,11/8/2013 13:00,Sell,11/8/2013 13:00,0.82598,0.82407,$18.10 ,"$10,469.50 ",19.1,Winning
619,11/10/2013 14:00,Buy,11/10/2013 14:00,0.82382,0.82494,$10.20 ,"$10,479.70 ",11.2,Winning
620,11/11/2013 1:00,Buy,11/11/2013 1:00,0.82687,0.8276,$6.30 ,"$10,486.00 ",7.3,Winning
621,11/11/2013 6:00,Buy,11/11/2013 6:00,0.82525,0.82488,($4.70),"$10,481.30 ",-3.7,Neutral
622,11/11/2013 8:00,Buy,11/11/2013 8:00,0.82322,0.82349,$1.70 ,"$10,483.00 ",2.7,Neutral
623,11/11/2013 11:00,Sell,11/11/2013 11:00,0.82376,0.82306,$6.00 ,"$10,489.00 ",7,Winning
624,11/11/2013 12:00,Buy,11/11/2013 12:00,0.82306,0.82302,($1.40),"$10,487.60 ",-0.4,Neutral
625,11/11/2013 16:00,Sell,11/11/2013 16:00,0.8255,0.82502,$3.80 ,"$10,491.40 ",4.8,Neutral
626,11/12/2013 7:00,Buy,11/12/2013 7:00,0.82081,0.82142,$5.10 ,"$10,496.50 ",6.1,Winning
627,11/13/2013 2:00,Buy,11/13/2013 3:00,0.82213,0.82148,($7.50),"$10,489.00 ",-6.5,Losing
628,11/13/2013 8:00,Sell,11/13/2013 8:00,0.82434,0.82354,$7.00 ,"$10,496.00 ",8,Winning
629,11/14/2013 0:00,Buy,11/14/2013 0:00,0.82849,0.82959,$10.00 ,"$10,506.00 ",11,Winning
630,11/14/2013 3:00,Buy,11/14/2013 3:00,0.82662,0.82612,($6.00),"$10,500.00 ",-5,Losing
631,11/14/2013 6:00,Buy,11/14/2013 6:00,0.82441,0.8244,($1.10),"$10,498.90 ",-0.1,Neutral
632,11/17/2013 15:00,Sell,11/17/2013 15:00,0.83443,0.83439,($0.60),"$10,498.30 ",0.4,Neutral
633,11/17/2013 20:00,Buy,11/17/2013 20:00,0.83353,0.8334,($2.30),"$10,496.00 ",-1.3,Neutral
634,11/18/2013 11:00,Buy,11/18/2013 11:00,0.83563,0.83676,$10.30 ,"$10,506.30 ",11.3,Winning
635,11/18/2013 14:00,Sell,11/18/2013 14:00,0.83568,0.83389,$16.90 ,"$10,523.20 ",17.9,Winning
636,11/18/2013 22:00,Sell,11/18/2013 22:00,0.83161,0.83139,$1.20 ,"$10,524.40 ",2.2,Neutral
637,11/19/2013 12:00,Sell,11/19/2013 12:00,0.83388,0.83515,($13.70),"$10,510.70 ",-12.7,Losing
638,11/19/2013 21:00,Buy,11/20/2013 0:00,0.83461,0.8338,($9.10),"$10,501.60 ",-8.1,Losing
639,11/20/2013 1:00,Sell,11/20/2013 2:00,0.8338,0.83375,($0.50),"$10,501.10 ",0.5,Neutral
640,11/20/2013 4:00,Sell,11/20/2013 4:00,0.83299,0.83365,($7.60),"$10,493.50 ",-6.6,Losing
641,11/20/2013 14:00,Buy,11/20/2013 14:00,0.82799,0.82593,($21.60),"$10,471.90 ",-20.6,Losing
642,11/20/2013 16:00,Buy,11/20/2013 16:00,0.82634,0.8269,$4.60 ,"$10,476.50 ",5.6,Winning
643,11/20/2013 17:00,Sell,11/20/2013 17:00,0.8269,0.82701,($2.10),"$10,474.40 ",-1.1,Neutral
644,11/20/2013 19:00,Sell,11/20/2013 19:00,0.82661,0.82668,($1.70),"$10,472.70 ",-0.7,Neutral
645,11/22/2013 0:00,Buy,11/22/2013 1:00,0.81955,0.82187,$22.20 ,"$10,494.90 ",23.2,Winning
646,11/22/2013 7:00,Buy,11/22/2013 7:00,0.8156,0.81561,($0.90),"$10,494.00 ",0.1,Neutral
647,11/22/2013 9:00,Buy,11/22/2013 9:00,0.81478,0.81393,($9.50),"$10,484.50 ",-8.5,Losing
648,11/24/2013 19:00,Sell,11/24/2013 19:00,0.81918,0.82102,($19.40),"$10,465.10 ",-18.4,Losing
649,11/26/2013 5:00,Buy,11/26/2013 5:00,0.82056,0.82068,$0.20 ,"$10,465.30 ",1.2,Neutral
650,11/27/2013 12:00,Buy,11/27/2013 12:00,0.81246,0.81268,$1.20 ,"$10,466.50 ",2.2,Neutral
651,11/28/2013 0:00,Sell,11/28/2013 0:00,0.81745,0.81726,$0.90 ,"$10,467.40 ",1.9,Neutral
652,11/29/2013 11:00,Sell,11/29/2013 11:00,0.81621,0.81533,$7.80 ,"$10,475.20 ",8.8,Winning
653,12/3/2013 18:00,Buy,12/3/2013 18:00,0.82358,0.82378,$1.00 ,"$10,476.20 ",2,Neutral
654,12/4/2013 0:00,Sell,12/4/2013 0:00,0.81955,0.81916,$2.90 ,"$10,479.10 ",3.9,Neutral
655,12/4/2013 8:00,Sell,12/4/2013 8:00,0.82046,0.81865,$17.10 ,"$10,496.20 ",18.1,Winning
656,12/11/2013 6:00,Buy,12/11/2013 8:00,0.82505,0.82456,($5.90),"$10,490.30 ",-4.9,Neutral
657,12/11/2013 10:00,Buy,12/11/2013 10:00,0.8231,0.82175,($14.50),"$10,475.80 ",-13.5,Losing
658,12/13/2013 0:00,Buy,12/13/2013 0:00,0.82195,0.82177,($2.80),"$10,473.00 ",-1.8,Neutral
659,12/13/2013 4:00,Sell,12/13/2013 4:00,0.82518,0.82279,$22.90 ,"$10,495.90 ",23.9,Winning
660,12/13/2013 6:00,Buy,12/13/2013 6:00,0.82067,0.82081,$0.40 ,"$10,496.30 ",1.4,Neutral
661,12/20/2013 8:00,Sell,12/20/2013 8:00,0.81668,0.81642,$1.60 ,"$10,497.90 ",2.6,Neutral
662,12/24/2013 0:00,Sell,12/24/2013 0:00,0.81828,0.81836,($1.80),"$10,496.10 ",-0.8,Neutral
663,12/26/2013 2:00,Buy,12/26/2013 2:00,0.8165,0.81642,($1.80),"$10,494.30 ",-0.8,Neutral
664,12/26/2013 4:00,Buy,12/26/2013 5:00,0.81639,0.81654,$0.50 ,"$10,494.80 ",1.5,Neutral
665,12/26/2013 7:00,Sell,12/26/2013 7:00,0.8162,0.81596,$1.40 ,"$10,496.20 ",2.4,Neutral
666,12/30/2013 17:00,Buy,12/30/2013 18:00,0.82007,0.82136,$11.90 ,"$10,508.10 ",12.9,Winning
667,1/2/2014 3:00,Buy,1/2/2014 3:00,0.81823,0.81916,$8.30 ,"$10,516.40 ",9.3,Winning
668,1/2/2014 15:00,Buy,1/2/2014 15:00,0.8174,0.81838,$8.80 ,"$10,525.20 ",9.8,Winning
669,1/3/2014 0:00,Sell,1/3/2014 0:00,0.82391,0.82441,($6.00),"$10,519.20 ",-5,Neutral
670,1/5/2014 17:00,Buy,1/5/2014 17:00,0.82672,0.8259,($9.20),"$10,510.00 ",-8.2,Losing
671,1/10/2014 5:00,Sell,1/10/2014 5:00,0.82344,0.82307,$2.70 ,"$10,512.70 ",3.7,Neutral
672,1/10/2014 7:00,Buy,1/10/2014 7:00,0.82079,0.82186,$9.70 ,"$10,522.40 ",10.7,Winning
673,1/10/2014 13:00,Sell,1/10/2014 13:00,0.82927,0.82942,($2.50),"$10,519.90 ",-1.5,Neutral
674,1/12/2014 16:00,Buy,1/12/2014 18:00,0.82874,0.8301,$12.60 ,"$10,532.50 ",13.6,Winning
675,1/12/2014 20:00,Buy,1/12/2014 20:00,0.82828,0.83198,$36.00 ,"$10,568.50 ",37,Winning
676,1/12/2014 23:00,Sell,1/12/2014 23:00,0.83342,0.83294,$3.80 ,"$10,572.30 ",4.8,Neutral
677,1/14/2014 18:00,Buy,1/14/2014 18:00,0.83614,0.83646,$2.20 ,"$10,574.50 ",3.2,Neutral
678,1/14/2014 22:00,Buy,1/14/2014 22:00,0.83399,0.83392,($1.70),"$10,572.80 ",-0.7,Neutral
679,1/15/2014 1:00,Buy,1/15/2014 1:00,0.83379,0.83396,$0.70 ,"$10,573.50 ",1.7,Neutral
680,1/15/2014 2:00,Sell,1/15/2014 3:00,0.83396,0.83426,($4.00),"$10,569.50 ",-3,Neutral
681,1/15/2014 18:00,Sell,1/15/2014 18:00,0.83296,0.833,($1.40),"$10,568.10 ",-0.4,Neutral
682,1/16/2014 3:00,Buy,1/16/2014 3:00,0.83159,0.83095,($7.40),"$10,560.70 ",-6.4,Losing
683,1/16/2014 13:00,Sell,1/16/2014 13:00,0.83371,0.83446,($8.50),"$10,552.20 ",-7.5,Losing
684,1/16/2014 15:00,Sell,1/16/2014 16:00,0.8351,0.83513,($1.30),"$10,550.90 ",-0.3,Neutral
685,1/17/2014 3:00,Sell,1/17/2014 3:00,0.82914,0.82853,$5.10 ,"$10,556.00 ",6.1,Winning
686,1/17/2014 4:00,Buy,1/17/2014 5:00,0.82853,0.82719,($14.40),"$10,541.60 ",-13.4,Losing
687,1/17/2014 8:00,Sell,1/17/2014 8:00,0.82681,0.82755,($8.40),"$10,533.20 ",-7.4,Losing
688,1/17/2014 11:00,Buy,1/17/2014 12:00,0.82575,0.82577,($0.80),"$10,532.40 ",0.2,Neutral
689,1/20/2014 17:00,Sell,1/20/2014 17:00,0.83228,0.83297,($7.90),"$10,524.50 ",-6.9,Losing
690,1/22/2014 10:00,Buy,1/22/2014 10:00,0.83164,0.8312,($5.40),"$10,519.10 ",-4.4,Neutral
691,1/22/2014 12:00,Buy,1/22/2014 12:00,0.83034,0.83091,$4.70 ,"$10,523.80 ",5.7,Winning
692,1/23/2014 2:00,Sell,1/23/2014 3:00,0.82979,0.82993,($2.40),"$10,521.40 ",-1.4,Neutral
693,1/26/2014 14:00,Buy,1/26/2014 14:00,0.82155,0.82293,$12.80 ,"$10,534.20 ",13.8,Winning
694,1/26/2014 17:00,Buy,1/26/2014 17:00,0.82175,0.82374,$18.90 ,"$10,553.10 ",19.9,Winning
695,1/27/2014 2:00,Sell,1/27/2014 2:00,0.82419,0.82501,($9.20),"$10,543.90 ",-8.2,Losing
696,1/27/2014 5:00,Buy,1/27/2014 5:00,0.82265,0.82232,($4.30),"$10,539.60 ",-3.3,Neutral
697,1/28/2014 8:00,Buy,1/28/2014 8:00,0.8262,0.82718,$8.80 ,"$10,548.40 ",9.8,Winning
698,1/28/2014 11:00,Buy,1/28/2014 11:00,0.82594,0.82548,($5.60),"$10,542.80 ",-4.6,Neutral
699,1/29/2014 1:00,Buy,1/29/2014 1:00,0.82731,0.82819,$7.80 ,"$10,550.60 ",8.8,Winning
700,1/29/2014 4:00,Buy,1/29/2014 4:00,0.82683,0.82849,$15.60 ,"$10,566.20 ",16.6,Winning
701,1/30/2014 19:00,Sell,1/30/2014 19:00,0.8178,0.8154,$23.00 ,"$10,589.20 ",24,Winning
702,1/31/2014 7:00,Buy,1/31/2014 8:00,0.81078,0.80765,($32.30),"$10,556.90 ",-31.3,Losing
703,1/31/2014 11:00,Sell,1/31/2014 11:00,0.80852,0.80884,($4.20),"$10,552.70 ",-3.2,Neutral
704,2/2/2014 14:00,Buy,2/2/2014 14:00,0.80749,0.80924,$16.50 ,"$10,569.20 ",17.5,Winning
705,2/2/2014 16:00,Sell,2/2/2014 16:00,0.80998,0.8096,$2.80 ,"$10,572.00 ",3.8,Neutral
706,2/2/2014 18:00,Sell,2/2/2014 18:00,0.8106,0.81004,$4.60 ,"$10,576.60 ",5.6,Winning
707,2/5/2014 10:00,Buy,2/5/2014 10:00,0.81984,0.82076,$8.20 ,"$10,584.80 ",9.2,Winning
708,2/6/2014 3:00,Buy,2/6/2014 3:00,0.8224,0.82201,($4.90),"$10,579.90 ",-3.9,Neutral
709,2/11/2014 5:00,Sell,2/11/2014 5:00,0.83259,0.83178,$7.10 ,"$10,587.00 ",8.1,Winning
710,2/11/2014 9:00,Buy,2/11/2014 9:00,0.83008,0.83081,$6.30 ,"$10,593.30 ",7.3,Winning
711,2/11/2014 17:00,Buy,2/11/2014 18:00,0.83188,0.83075,($12.30),"$10,581.00 ",-11.3,Losing
712,2/12/2014 8:00,Buy,2/12/2014 9:00,0.83332,0.8333,($1.20),"$10,579.80 ",-0.2,Neutral
713,2/18/2014 7:00,Sell,2/18/2014 7:00,0.83206,0.83129,$6.70 ,"$10,586.50 ",7.7,Winning
714,2/18/2014 20:00,Buy,2/18/2014 20:00,0.8285,0.8295,$9.00 ,"$10,595.50 ",10,Winning
715,2/19/2014 17:00,Buy,2/19/2014 18:00,0.82707,0.82723,$0.60 ,"$10,596.10 ",1.6,Neutral
716,2/26/2014 13:00,Buy,2/26/2014 13:00,0.82931,0.82905,($3.60),"$10,592.50 ",-2.6,Neutral
717,2/26/2014 15:00,Sell,2/26/2014 15:00,0.83115,0.83072,$3.30 ,"$10,595.80 ",4.3,Neutral
718,2/26/2014 21:00,Sell,2/26/2014 21:00,0.83233,0.83185,$3.80 ,"$10,599.60 ",4.8,Neutral
719,2/28/2014 1:00,Buy,2/28/2014 1:00,0.83855,0.83991,$12.60 ,"$10,612.20 ",13.6,Winning
720,2/28/2014 5:00,Sell,2/28/2014 5:00,0.8422,0.84074,$13.60 ,"$10,625.80 ",14.6,Winning
721,2/28/2014 12:00,Buy,2/28/2014 12:00,0.83874,0.83866,($1.80),"$10,624.00 ",-0.8,Neutral
722,2/28/2014 16:00,Buy,3/2/2014 14:00,0.83831,0.83565,($27.60),"$10,596.40 ",-26.6,Losing
723,3/5/2014 17:00,Buy,3/5/2014 18:00,0.84134,0.84112,($3.20),"$10,593.20 ",-2.2,Neutral
724,3/9/2014 15:00,Buy,3/9/2014 15:00,0.84363,0.84417,$4.40 ,"$10,597.60 ",5.4,Winning
725,3/9/2014 18:00,Sell,3/9/2014 18:00,0.84706,0.84678,$1.80 ,"$10,599.40 ",2.8,Neutral
726,3/13/2014 13:00,Buy,3/13/2014 15:00,0.85576,0.85401,($18.50),"$10,580.90 ",-17.5,Losing
727,3/17/2014 21:00,Sell,3/17/2014 21:00,0.85633,0.85606,$1.70 ,"$10,582.60 ",2.7,Neutral
728,3/18/2014 16:00,Buy,3/18/2014 16:00,0.86194,0.86207,$0.30 ,"$10,582.90 ",1.3,Neutral
729,3/18/2014 21:00,Buy,3/18/2014 21:00,0.86067,0.86082,$0.50 ,"$10,583.40 ",1.5,Neutral
730,3/19/2014 1:00,Sell,3/19/2014 1:00,0.86098,0.86062,$2.60 ,"$10,586.00 ",3.6,Neutral
731,3/19/2014 8:00,Sell,3/19/2014 8:00,0.86217,0.86182,$2.50 ,"$10,588.50 ",3.5,Neutral
732,3/19/2014 15:00,Buy,3/19/2014 15:00,0.85484,0.85509,$1.50 ,"$10,590.00 ",2.5,Neutral
733,3/19/2014 18:00,Buy,3/19/2014 18:00,0.8536,0.85301,($6.90),"$10,583.10 ",-5.9,Losing
734,3/19/2014 21:00,Buy,3/19/2014 21:00,0.85265,0.85301,$2.60 ,"$10,585.70 ",3.6,Neutral
735,3/20/2014 1:00,Sell,3/20/2014 1:00,0.8525,0.85272,($3.20),"$10,582.50 ",-2.2,Neutral
736,3/20/2014 12:00,Sell,3/20/2014 12:00,0.85363,0.85399,($4.60),"$10,577.90 ",-3.6,Neutral
737,3/25/2014 13:00,Sell,3/25/2014 13:00,0.85627,0.85715,($9.80),"$10,568.10 ",-8.8,Losing
738,3/26/2014 17:00,Buy,3/26/2014 17:00,0.85877,0.85962,$7.50 ,"$10,575.60 ",8.5,Winning
739,3/27/2014 1:00,Sell,3/27/2014 1:00,0.86287,0.86348,($7.10),"$10,568.50 ",-6.1,Losing
740,3/27/2014 18:00,Buy,3/27/2014 18:00,0.86662,0.86669,($0.30),"$10,568.20 ",0.7,Neutral
741,4/1/2014 22:00,Sell,4/1/2014 22:00,0.86005,0.86025,($3.00),"$10,565.20 ",-2,Neutral
742,4/2/2014 1:00,Sell,4/2/2014 1:00,0.85953,0.85979,($3.60),"$10,561.60 ",-2.6,Neutral
743,4/2/2014 7:00,Buy,4/2/2014 7:00,0.85646,0.85695,$3.90 ,"$10,565.50 ",4.9,Neutral
744,4/3/2014 0:00,Buy,4/3/2014 0:00,0.85436,0.85394,($5.20),"$10,560.30 ",-4.2,Neutral
745,4/6/2014 15:00,Sell,4/6/2014 16:00,0.85989,0.85742,$23.70 ,"$10,584.00 ",24.7,Winning
746,4/7/2014 0:00,Buy,4/7/2014 1:00,0.8597,0.85998,$1.80 ,"$10,585.80 ",2.8,Neutral
747,4/7/2014 8:00,Buy,4/7/2014 8:00,0.85828,0.85857,$1.90 ,"$10,587.70 ",2.9,Neutral
748,4/7/2014 11:00,Sell,4/7/2014 11:00,0.86078,0.85968,$10.00 ,"$10,597.70 ",11,Winning
749,4/7/2014 21:00,Sell,4/7/2014 21:00,0.86159,0.86288,($13.90),"$10,583.80 ",-12.9,Losing
750,4/8/2014 19:00,Buy,4/8/2014 19:00,0.8663,0.86651,$1.10 ,"$10,584.90 ",2.1,Neutral
751,4/9/2014 3:00,Buy,4/9/2014 3:00,0.86885,0.86968,$7.30 ,"$10,592.20 ",8.3,Winning
752,4/9/2014 6:00,Buy,4/9/2014 6:00,0.86812,0.86861,$3.90 ,"$10,596.10 ",4.9,Neutral
753,4/9/2014 11:00,Buy,4/9/2014 11:00,0.86522,0.86585,$5.30 ,"$10,601.40 ",6.3,Winning
754,4/9/2014 13:00,Buy,4/9/2014 14:00,0.86497,0.87181,$67.40 ,"$10,668.80 ",68.4,Winning
755,4/10/2014 0:00,Buy,4/10/2014 0:00,0.87123,0.87187,$5.40 ,"$10,674.20 ",6.4,Winning
756,4/10/2014 5:00,Sell,4/10/2014 5:00,0.87184,0.87162,$1.20 ,"$10,675.40 ",2.2,Neutral
757,4/10/2014 6:00,Buy,4/10/2014 8:00,0.87162,0.86906,($26.60),"$10,648.80 ",-25.6,Losing
758,4/11/2014 0:00,Sell,4/11/2014 0:00,0.86393,0.86392,($0.90),"$10,647.90 ",0.1,Neutral
759,4/11/2014 2:00,Sell,4/11/2014 2:00,0.86554,0.86624,($8.00),"$10,639.90 ",-7,Losing
760,4/11/2014 4:00,Sell,4/11/2014 4:00,0.86735,0.86779,($5.40),"$10,634.50 ",-4.4,Neutral
761,4/15/2014 20:00,Buy,4/15/2014 20:00,0.8596,0.85889,($8.10),"$10,626.40 ",-7.1,Losing
762,4/16/2014 0:00,Sell,4/16/2014 0:00,0.8594,0.8589,$4.00 ,"$10,630.40 ",5,Winning
763,4/16/2014 10:00,Buy,4/16/2014 10:00,0.85915,0.85966,$4.10 ,"$10,634.50 ",5.1,Winning
764,4/17/2014 0:00,Buy,4/17/2014 0:00,0.86246,0.8619,($6.60),"$10,627.90 ",-5.6,Losing
765,4/17/2014 15:00,Buy,4/17/2014 16:00,0.85679,0.85659,($3.00),"$10,624.90 ",-2,Neutral
766,4/18/2014 7:00,Sell,4/18/2014 7:00,0.85896,0.85805,$8.10 ,"$10,633.00 ",9.1,Winning
767,4/21/2014 3:00,Sell,4/21/2014 3:00,0.85847,0.8577,$6.70 ,"$10,639.70 ",7.7,Winning
768,4/22/2014 2:00,Sell,4/22/2014 3:00,0.85861,0.85814,$3.70 ,"$10,643.40 ",4.7,Neutral
769,4/22/2014 8:00,Sell,4/22/2014 8:00,0.86038,0.86108,($8.00),"$10,635.40 ",-7,Losing
770,4/22/2014 13:00,Buy,4/22/2014 13:00,0.85985,0.8598,($1.50),"$10,633.90 ",-0.5,Neutral
771,4/23/2014 7:00,Sell,4/23/2014 7:00,0.85924,0.85828,$8.60 ,"$10,642.50 ",9.6,Winning
772,4/23/2014 8:00,Buy,4/23/2014 8:00,0.85828,0.85714,($12.40),"$10,630.10 ",-11.4,Losing
773,4/23/2014 16:00,Sell,4/23/2014 16:00,0.85927,0.85755,$16.20 ,"$10,646.30 ",17.2,Winning
774,4/24/2014 2:00,Buy,4/24/2014 2:00,0.86188,0.86172,($2.60),"$10,643.70 ",-1.6,Neutral
775,4/24/2014 4:00,Buy,4/24/2014 4:00,0.85944,0.85871,($8.30),"$10,635.40 ",-7.3,Losing
776,4/24/2014 19:00,Buy,4/24/2014 19:00,0.85597,0.85687,$8.00 ,"$10,643.40 ",9,Winning
777,4/24/2014 21:00,Buy,4/24/2014 21:00,0.8552,0.85603,$7.30 ,"$10,650.70 ",8.3,Winning
778,4/28/2014 12:00,Buy,4/28/2014 12:00,0.85293,0.85293,($1.00),"$10,649.70 ",0,Neutral
779,4/28/2014 21:00,Buy,4/28/2014 21:00,0.85245,0.85252,($0.30),"$10,649.40 ",0.7,Neutral
780,4/29/2014 21:00,Sell,4/29/2014 21:00,0.857,0.85559,$13.10 ,"$10,662.50 ",14.1,Winning
781,4/30/2014 20:00,Buy,4/30/2014 20:00,0.86076,0.86098,$1.20 ,"$10,663.70 ",2.2,Neutral
782,5/1/2014 7:00,Buy,5/1/2014 9:00,0.86157,0.86049,($11.80),"$10,651.90 ",-10.8,Losing
783,5/1/2014 13:00,Sell,5/1/2014 13:00,0.86355,0.86257,$8.80 ,"$10,660.70 ",9.8,Winning
784,5/6/2014 22:00,Buy,5/6/2014 22:00,0.86967,0.86937,($4.00),"$10,656.70 ",-3,Neutral
785,5/7/2014 5:00,Buy,5/7/2014 5:00,0.86693,0.86702,($0.10),"$10,656.60 ",0.9,Neutral
786,5/7/2014 17:00,Buy,5/7/2014 17:00,0.86569,0.86539,($4.00),"$10,652.60 ",-3,Neutral
787,5/7/2014 21:00,Sell,5/7/2014 21:00,0.86497,0.86419,$6.80 ,"$10,659.40 ",7.8,Winning
788,5/8/2014 4:00,Buy,5/8/2014 4:00,0.86524,0.86605,$7.10 ,"$10,666.50 ",8.1,Winning
789,5/8/2014 21:00,Buy,5/8/2014 21:00,0.86309,0.86244,($7.50),"$10,659.00 ",-6.5,Losing
790,5/9/2014 5:00,Buy,5/9/2014 6:00,0.86341,0.86406,$5.50 ,"$10,664.50 ",6.5,Winning
791,5/9/2014 11:00,Buy,5/9/2014 11:00,0.8604,0.86091,$4.10 ,"$10,668.60 ",5.1,Winning
792,5/18/2014 21:00,Sell,5/18/2014 21:00,0.86419,0.86484,($7.50),"$10,661.10 ",-6.5,Losing
793,5/20/2014 6:00,Sell,5/20/2014 7:00,0.85851,0.85734,$10.70 ,"$10,671.80 ",11.7,Winning
794,5/20/2014 8:00,Buy,5/20/2014 8:00,0.85734,0.85758,$1.40 ,"$10,673.20 ",2.4,Neutral
795,5/20/2014 14:00,Buy,5/20/2014 14:00,0.85627,0.85749,$11.20 ,"$10,684.40 ",12.2,Winning
796,5/20/2014 20:00,Buy,5/20/2014 20:00,0.85612,0.85591,($3.10),"$10,681.30 ",-2.1,Neutral
797,5/21/2014 8:00,Buy,5/21/2014 10:00,0.85634,0.85527,($11.70),"$10,669.60 ",-10.7,Losing
798,5/21/2014 12:00,Buy,5/21/2014 13:00,0.85434,0.85425,($1.90),"$10,667.70 ",-0.9,Neutral
799,5/28/2014 5:00,Buy,5/28/2014 5:00,0.8496,0.8493,($4.00),"$10,663.70 ",-3,Neutral
800,5/28/2014 20:00,Buy,5/28/2014 20:00,0.84807,0.84876,$5.90 ,"$10,669.60 ",6.9,Winning
801,5/29/2014 9:00,Buy,5/29/2014 10:00,0.84732,0.84709,($3.30),"$10,666.30 ",-2.3,Neutral
802,6/3/2014 22:00,Buy,6/3/2014 23:00,0.84193,0.8418,($2.30),"$10,664.00 ",-1.3,Neutral
803,6/4/2014 1:00,Buy,6/4/2014 1:00,0.84132,0.84128,($1.40),"$10,662.60 ",-0.4,Neutral
804,6/9/2014 6:00,Buy,6/9/2014 6:00,0.85095,0.85184,$7.90 ,"$10,670.50 ",8.9,Winning
805,6/9/2014 9:00,Buy,6/9/2014 10:00,0.85032,0.84865,($17.70),"$10,652.80 ",-16.7,Losing
806,6/9/2014 13:00,Buy,6/9/2014 13:00,0.84855,0.84855,($1.00),"$10,651.80 ",0,Neutral
807,6/9/2014 22:00,Sell,6/9/2014 22:00,0.85033,0.85004,$1.90 ,"$10,653.70 ",2.9,Neutral
808,6/11/2014 17:00,Buy,6/11/2014 17:00,0.85333,0.86122,$77.90 ,"$10,731.60 ",78.9,Winning
809,6/13/2014 6:00,Buy,6/13/2014 7:00,0.86523,0.86613,$8.00 ,"$10,739.60 ",9,Winning
810,6/15/2014 23:00,Sell,6/15/2014 23:00,0.86777,0.86826,($5.90),"$10,733.70 ",-4.9,Neutral
811,6/16/2014 1:00,Sell,6/16/2014 1:00,0.86853,0.86944,($10.10),"$10,723.60 ",-9.1,Losing
812,6/16/2014 4:00,Buy,6/16/2014 4:00,0.86709,0.86722,$0.30 ,"$10,723.90 ",1.3,Neutral
813,6/16/2014 6:00,Buy,6/16/2014 6:00,0.86681,0.86749,$5.80 ,"$10,729.70 ",6.8,Winning
814,6/16/2014 9:00,Sell,6/16/2014 10:00,0.86694,0.86764,($8.00),"$10,721.70 ",-7,Losing
815,6/17/2014 0:00,Sell,6/17/2014 0:00,0.86578,0.86574,($0.60),"$10,721.10 ",0.4,Neutral
816,6/17/2014 13:00,Sell,6/17/2014 13:00,0.86523,0.86494,$1.90 ,"$10,723.00 ",2.9,Neutral
817,6/18/2014 22:00,Buy,6/18/2014 22:00,0.87095,0.87142,$3.70 ,"$10,726.70 ",4.7,Neutral
818,6/19/2014 12:00,Buy,6/19/2014 12:00,0.87141,0.87162,$1.10 ,"$10,727.80 ",2.1,Neutral
819,6/19/2014 15:00,Sell,6/19/2014 16:00,0.8712,0.87119,($0.90),"$10,726.90 ",0.1,Neutral
820,6/23/2014 6:00,Buy,6/23/2014 6:00,0.87295,0.87338,$3.30 ,"$10,730.20 ",4.3,Neutral
821,6/23/2014 9:00,Buy,6/23/2014 9:00,0.87238,0.87167,($8.10),"$10,722.10 ",-7.1,Losing
822,6/23/2014 11:00,Buy,6/23/2014 11:00,0.87127,0.87064,($7.30),"$10,714.80 ",-6.3,Losing
823,6/23/2014 13:00,Sell,6/23/2014 13:00,0.87101,0.87115,($2.40),"$10,712.40 ",-1.4,Neutral
824,6/23/2014 18:00,Sell,6/23/2014 18:00,0.87192,0.87133,$4.90 ,"$10,717.30 ",5.9,Winning
825,6/24/2014 4:00,Buy,6/24/2014 4:00,0.87046,0.87069,$1.30 ,"$10,718.60 ",2.3,Neutral
826,6/24/2014 6:00,Buy,6/24/2014 6:00,0.87032,0.87074,$3.20 ,"$10,721.80 ",4.2,Neutral
827,6/24/2014 9:00,Buy,6/24/2014 9:00,0.86971,0.86926,($5.50),"$10,716.30 ",-4.5,Neutral
828,6/24/2014 11:00,Buy,6/24/2014 11:00,0.86823,0.86845,$1.20 ,"$10,717.50 ",2.2,Neutral
829,6/24/2014 18:00,Buy,6/24/2014 18:00,0.86699,0.8673,$2.10 ,"$10,719.60 ",3.1,Neutral
830,6/25/2014 18:00,Buy,6/25/2014 18:00,0.87298,0.87298,($1.00),"$10,718.60 ",0,Neutral
831,6/27/2014 11:00,Sell,6/27/2014 11:00,0.87683,0.87626,$4.70 ,"$10,723.30 ",5.7,Winning
832,6/27/2014 15:00,Sell,6/27/2014 15:00,0.87769,0.87786,($2.70),"$10,720.60 ",-1.7,Neutral
833,7/1/2014 17:00,Buy,7/1/2014 17:00,0.87721,0.87698,($3.30),"$10,717.30 ",-2.3,Neutral
834,7/1/2014 20:00,Buy,7/1/2014 20:00,0.87609,0.87565,($5.40),"$10,711.90 ",-4.4,Neutral
835,7/4/2014 6:00,Buy,7/4/2014 6:00,0.87328,0.8739,$5.20 ,"$10,717.10 ",6.2,Winning
836,7/7/2014 1:00,Sell,7/7/2014 1:00,0.87197,0.87215,($2.80),"$10,714.30 ",-1.8,Neutral
837,7/7/2014 12:00,Sell,7/7/2014 12:00,0.87656,0.87624,$2.20 ,"$10,716.50 ",3.2,Neutral
838,7/7/2014 17:00,Buy,7/7/2014 18:00,0.87549,0.87463,($9.60),"$10,706.90 ",-8.6,Losing
839,7/7/2014 20:00,Sell,7/7/2014 20:00,0.87467,0.87525,($6.80),"$10,700.10 ",-5.8,Losing
840,7/8/2014 23:00,Buy,7/8/2014 23:00,0.87846,0.8786,$0.40 ,"$10,700.50 ",1.4,Neutral
841,7/9/2014 8:00,Buy,7/9/2014 8:00,0.87965,0.87961,($1.40),"$10,699.10 ",-0.4,Neutral
842,7/10/2014 6:00,Buy,7/10/2014 6:00,0.87986,0.88015,$1.90 ,"$10,701.00 ",2.9,Neutral
843,7/10/2014 11:00,Sell,7/10/2014 11:00,0.88111,0.88113,($1.20),"$10,699.80 ",-0.2,Neutral
844,7/15/2014 19:00,Buy,7/15/2014 19:00,0.87271,0.87256,($2.50),"$10,697.30 ",-1.5,Neutral
845,7/15/2014 22:00,Buy,7/15/2014 22:00,0.87231,0.86983,($25.80),"$10,671.50 ",-24.8,Losing
846,7/16/2014 21:00,Buy,7/16/2014 21:00,0.86996,0.86953,($5.30),"$10,666.20 ",-4.3,Neutral
847,7/16/2014 23:00,Buy,7/16/2014 23:00,0.86913,0.86869,($5.40),"$10,660.80 ",-4.4,Neutral
848,7/17/2014 17:00,Buy,7/17/2014 18:00,0.86665,0.8658,($9.50),"$10,651.30 ",-8.5,Losing
849,7/17/2014 20:00,Sell,7/17/2014 20:00,0.86647,0.86554,$8.30 ,"$10,659.60 ",9.3,Winning
850,7/17/2014 23:00,Sell,7/17/2014 23:00,0.86775,0.86764,$0.10 ,"$10,659.70 ",1.1,Neutral
851,7/24/2014 1:00,Buy,7/24/2014 3:00,0.85837,0.85865,$1.80 ,"$10,661.50 ",2.8,Neutral
852,7/24/2014 6:00,Sell,7/24/2014 6:00,0.85929,0.8591,$0.90 ,"$10,662.40 ",1.9,Neutral
853,7/24/2014 10:00,Buy,7/24/2014 10:00,0.85739,0.85866,$11.70 ,"$10,674.10 ",12.7,Winning
854,7/24/2014 15:00,Buy,7/24/2014 15:00,0.85734,0.8576,$1.60 ,"$10,675.70 ",2.6,Neutral
855,7/24/2014 17:00,Buy,7/24/2014 17:00,0.85702,0.85642,($7.00),"$10,668.70 ",-6,Losing
856,7/25/2014 5:00,Buy,7/25/2014 6:00,0.85448,0.85458,$0.00 ,"$10,668.70 ",1,Neutral
857,7/28/2014 0:00,Sell,7/28/2014 0:00,0.85413,0.85324,$7.90 ,"$10,676.60 ",8.9,Winning
858,7/28/2014 7:00,Sell,7/28/2014 7:00,0.85589,0.85535,$4.40 ,"$10,681.00 ",5.4,Winning
859,7/29/2014 12:00,Buy,7/29/2014 12:00,0.84946,0.85013,$5.70 ,"$10,686.70 ",6.7,Winning
860,7/30/2014 5:00,Buy,7/30/2014 5:00,0.85043,0.85085,$3.20 ,"$10,689.90 ",4.2,Neutral
861,7/30/2014 8:00,Sell,7/30/2014 8:00,0.851,0.84869,$22.10 ,"$10,712.00 ",23.1,Winning
862,7/30/2014 12:00,Buy,7/30/2014 12:00,0.8467,0.84767,$8.70 ,"$10,720.70 ",9.7,Winning
863,8/5/2014 12:00,Buy,8/5/2014 12:00,0.84584,0.84649,$5.50 ,"$10,726.20 ",6.5,Winning
864,8/6/2014 20:00,Buy,8/6/2014 20:00,0.84701,0.84735,$2.40 ,"$10,728.60 ",3.4,Neutral
865,8/7/2014 7:00,Sell,8/7/2014 7:00,0.84724,0.84696,$1.80 ,"$10,730.40 ",2.8,Neutral
866,8/12/2014 2:00,Buy,8/12/2014 2:00,0.84114,0.84162,$3.80 ,"$10,734.20 ",4.8,Neutral
867,8/12/2014 20:00,Buy,8/12/2014 20:00,0.84237,0.84238,($0.90),"$10,733.30 ",0.1,Neutral
868,8/14/2014 11:00,Buy,8/14/2014 11:00,0.84896,0.84911,$0.50 ,"$10,733.80 ",1.5,Neutral
869,8/14/2014 13:00,Buy,8/14/2014 13:00,0.84867,0.84862,($1.50),"$10,732.30 ",-0.5,Neutral
870,8/14/2014 20:00,Buy,8/14/2014 21:00,0.84793,0.84744,($5.90),"$10,726.40 ",-4.9,Neutral
871,8/19/2014 10:00,Buy,8/19/2014 10:00,0.84396,0.84463,$5.70 ,"$10,732.10 ",6.7,Winning
872,8/19/2014 15:00,Buy,8/19/2014 15:00,0.84251,0.84194,($6.70),"$10,725.40 ",-5.7,Losing
873,8/20/2014 15:00,Buy,8/20/2014 17:00,0.83793,0.83666,($13.70),"$10,711.70 ",-12.7,Losing
874,8/20/2014 21:00,Buy,8/20/2014 21:00,0.83583,0.83544,($4.90),"$10,706.80 ",-3.9,Neutral
875,8/25/2014 5:00,Sell,8/25/2014 5:00,0.83643,0.83667,($3.40),"$10,703.40 ",-2.4,Neutral
876,8/25/2014 19:00,Sell,8/25/2014 19:00,0.83242,0.83123,$10.90 ,"$10,714.30 ",11.9,Winning
877,8/25/2014 20:00,Buy,8/25/2014 20:00,0.83123,0.83231,$9.80 ,"$10,724.10 ",10.8,Winning
878,8/25/2014 23:00,Sell,8/25/2014 23:00,0.83455,0.83421,$2.40 ,"$10,726.50 ",3.4,Neutral
879,8/26/2014 7:00,Sell,8/26/2014 7:00,0.83333,0.83283,$4.00 ,"$10,730.50 ",5,Winning
880,8/28/2014 3:00,Buy,8/28/2014 3:00,0.83851,0.83882,$2.10 ,"$10,732.60 ",3.1,Neutral
881,8/28/2014 12:00,Sell,8/28/2014 12:00,0.8373,0.83693,$2.70 ,"$10,735.30 ",3.7,Neutral
882,9/2/2014 5:00,Buy,9/2/2014 5:00,0.83348,0.83271,($8.70),"$10,726.60 ",-7.7,Losing
883,9/2/2014 11:00,Sell,9/2/2014 11:00,0.83041,0.83071,($4.00),"$10,722.60 ",-3,Neutral
884,9/2/2014 20:00,Buy,9/2/2014 20:00,0.82994,0.83064,$6.00 ,"$10,728.60 ",7,Winning
885,9/3/2014 0:00,Buy,9/3/2014 0:00,0.82901,0.82957,$4.60 ,"$10,733.20 ",5.6,Winning
886,9/7/2014 17:00,Buy,9/7/2014 17:00,0.82999,0.83048,$3.90 ,"$10,737.10 ",4.9,Neutral
887,9/7/2014 22:00,Sell,9/7/2014 22:00,0.83262,0.83214,$3.80 ,"$10,740.90 ",4.8,Neutral
888,9/8/2014 23:00,Buy,9/9/2014 0:00,0.82582,0.82571,($2.10),"$10,738.80 ",-1.1,Neutral
889,9/9/2014 10:00,Buy,9/9/2014 10:00,0.82429,0.82612,$17.30 ,"$10,756.10 ",18.3,Winning
890,9/9/2014 13:00,Buy,9/9/2014 14:00,0.82314,0.82272,($5.20),"$10,750.90 ",-4.2,Neutral
891,9/9/2014 19:00,Sell,9/9/2014 19:00,0.82514,0.82542,($3.80),"$10,747.10 ",-2.8,Neutral
892,9/9/2014 22:00,Buy,9/9/2014 22:00,0.82447,0.8241,($4.70),"$10,742.40 ",-3.7,Neutral
893,9/11/2014 1:00,Buy,9/11/2014 2:00,0.81869,0.81794,($8.50),"$10,733.90 ",-7.5,Losing
894,9/11/2014 5:00,Buy,9/11/2014 5:00,0.81693,0.81806,$10.30 ,"$10,744.20 ",11.3,Winning
895,9/11/2014 19:00,Sell,9/11/2014 19:00,0.81941,0.81812,$11.90 ,"$10,756.10 ",12.9,Winning
896,9/12/2014 14:00,Sell,9/12/2014 14:00,0.81522,0.81443,$6.90 ,"$10,763.00 ",7.9,Winning
897,9/14/2014 15:00,Buy,9/14/2014 15:00,0.81326,0.81556,$22.00 ,"$10,785.00 ",23,Winning
898,9/15/2014 10:00,Sell,9/15/2014 10:00,0.81782,0.81654,$11.80 ,"$10,796.80 ",12.8,Winning
899,9/16/2014 1:00,Buy,9/16/2014 2:00,0.8164,0.81584,($6.60),"$10,790.20 ",-5.6,Losing
900,9/16/2014 17:00,Buy,9/16/2014 19:00,0.81959,0.81893,($7.60),"$10,782.60 ",-6.6,Losing
901,9/16/2014 21:00,Buy,9/16/2014 22:00,0.81827,0.81737,($10.00),"$10,772.60 ",-9,Losing
902,9/23/2014 14:00,Sell,9/23/2014 14:00,0.80611,0.80637,($3.60),"$10,769.00 ",-2.6,Neutral
903,9/24/2014 8:00,Buy,9/24/2014 9:00,0.80633,0.80525,($11.80),"$10,757.20 ",-10.8,Losing
904,9/25/2014 3:00,Buy,9/25/2014 4:00,0.79549,0.79565,$0.60 ,"$10,757.80 ",1.6,Neutral
905,9/25/2014 6:00,Sell,9/25/2014 6:00,0.79577,0.79611,($4.40),"$10,753.40 ",-3.4,Neutral
906,9/30/2014 6:00,Buy,9/30/2014 7:00,0.77551,0.77595,$3.40 ,"$10,756.80 ",4.4,Neutral
907,10/2/2014 8:00,Buy,10/2/2014 8:00,0.78625,0.78771,$13.60 ,"$10,770.40 ",14.6,Winning
908,10/2/2014 11:00,Sell,10/2/2014 11:00,0.78552,0.78789,($24.70),"$10,745.70 ",-23.7,Losing
909,10/2/2014 20:00,Buy,10/2/2014 21:00,0.78892,0.78621,($28.10),"$10,717.60 ",-27.1,Losing
910,10/2/2014 23:00,Sell,10/3/2014 0:00,0.78664,0.78699,($4.50),"$10,713.10 ",-3.5,Neutral
911,10/3/2014 7:00,Buy,10/3/2014 7:00,0.78497,0.78582,$7.50 ,"$10,720.60 ",8.5,Winning
912,10/3/2014 10:00,Buy,10/3/2014 11:00,0.77741,0.77694,($5.70),"$10,714.90 ",-4.7,Neutral
913,10/6/2014 21:00,Buy,10/6/2014 22:00,0.78104,0.77945,($16.90),"$10,698.00 ",-15.9,Losing
914,10/7/2014 0:00,Sell,10/7/2014 0:00,0.77988,0.78071,($9.30),"$10,688.70 ",-8.3,Losing
915,10/9/2014 15:00,Buy,10/9/2014 16:00,0.78536,0.7861,$6.40 ,"$10,695.10 ",7.4,Winning
916,10/12/2014 16:00,Buy,10/12/2014 16:00,0.78052,0.78214,$15.20 ,"$10,710.30 ",16.2,Winning
917,10/12/2014 18:00,Sell,10/12/2014 18:00,0.78081,0.78105,($3.40),"$10,706.90 ",-2.4,Neutral
918,10/12/2014 21:00,Sell,10/12/2014 22:00,0.78392,0.78718,($33.60),"$10,673.30 ",-32.6,Losing
919,10/15/2014 6:00,Buy,10/15/2014 6:00,0.78239,0.7829,$4.10 ,"$10,677.40 ",5.1,Winning
920,10/16/2014 6:00,Buy,10/16/2014 6:00,0.78889,0.79157,$25.80 ,"$10,703.20 ",26.8,Winning
921,10/16/2014 16:00,Buy,10/16/2014 16:00,0.79375,0.79484,$9.90 ,"$10,713.10 ",10.9,Winning
922,10/20/2014 21:00,Sell,10/20/2014 21:00,0.79662,0.7962,$3.20 ,"$10,716.30 ",4.2,Neutral
923,10/21/2014 5:00,Buy,10/21/2014 5:00,0.7985,0.79893,$3.30 ,"$10,719.60 ",4.3,Neutral
924,10/21/2014 15:00,Buy,10/21/2014 15:00,0.79489,0.79554,$5.50 ,"$10,725.10 ",6.5,Winning
925,10/21/2014 20:00,Sell,10/21/2014 20:00,0.79661,0.7965,$0.10 ,"$10,725.20 ",1.1,Neutral
926,10/22/2014 22:00,Buy,10/22/2014 22:00,0.7839,0.78459,$5.90 ,"$10,731.10 ",6.9,Winning
927,10/22/2014 23:00,Sell,10/22/2014 23:00,0.78459,0.78522,($7.30),"$10,723.80 ",-6.3,Losing
928,10/23/2014 9:00,Buy,10/23/2014 9:00,0.78448,0.78429,($2.90),"$10,720.90 ",-1.9,Neutral
929,10/23/2014 16:00,Buy,10/23/2014 16:00,0.78115,0.78215,$9.00 ,"$10,729.90 ",10,Winning
930,10/24/2014 10:00,Sell,10/24/2014 10:00,0.78731,0.7855,$17.10 ,"$10,747.00 ",18.1,Winning
931,10/24/2014 13:00,Buy,10/24/2014 13:00,0.78455,0.78532,$6.70 ,"$10,753.70 ",7.7,Winning
932,10/26/2014 14:00,Sell,10/26/2014 14:00,0.78497,0.78588,($10.10),"$10,743.60 ",-9.1,Losing
933,10/27/2014 7:00,Sell,10/27/2014 7:00,0.78667,0.78662,($0.50),"$10,743.10 ",0.5,Neutral
934,10/27/2014 18:00,Buy,10/27/2014 19:00,0.78877,0.78907,$2.00 ,"$10,745.10 ",3,Neutral
935,10/28/2014 5:00,Buy,10/28/2014 5:00,0.78917,0.78928,$0.10 ,"$10,745.20 ",1.1,Neutral
936,10/30/2014 17:00,Buy,10/30/2014 17:00,0.78377,0.78425,$3.80 ,"$10,749.00 ",4.8,Neutral
937,10/30/2014 19:00,Buy,10/30/2014 19:00,0.7834,0.78378,$2.80 ,"$10,751.80 ",3.8,Neutral
938,11/4/2014 3:00,Buy,11/4/2014 3:00,0.77326,0.77489,$15.30 ,"$10,767.10 ",16.3,Winning
939,11/5/2014 3:00,Buy,11/5/2014 3:00,0.7784,0.77623,($22.70),"$10,744.40 ",-21.7,Losing
940,11/5/2014 6:00,Sell,11/5/2014 6:00,0.77438,0.77277,$15.10 ,"$10,759.50 ",16.1,Winning
941,11/5/2014 7:00,Buy,11/5/2014 7:00,0.77277,0.7732,$3.30 ,"$10,762.80 ",4.3,Neutral
942,11/5/2014 10:00,Buy,11/5/2014 10:00,0.77117,0.77152,$2.50 ,"$10,765.30 ",3.5,Neutral
943,11/5/2014 18:00,Buy,11/5/2014 18:00,0.77056,0.77103,$3.70 ,"$10,769.00 ",4.7,Neutral
944,11/5/2014 22:00,Sell,11/5/2014 22:00,0.76866,0.76849,$0.70 ,"$10,769.70 ",1.7,Neutral
945,11/10/2014 14:00,Buy,11/10/2014 15:00,0.77542,0.77444,($10.80),"$10,758.90 ",-9.8,Losing
946,11/12/2014 18:00,Buy,11/12/2014 18:00,0.78626,0.78614,($2.20),"$10,756.70 ",-1.2,Neutral
947,11/13/2014 13:00,Buy,11/13/2014 13:00,0.78842,0.78857,$0.50 ,"$10,757.20 ",1.5,Neutral
948,11/13/2014 16:00,Sell,11/13/2014 16:00,0.78861,0.78783,$6.80 ,"$10,764.00 ",7.8,Winning
949,11/17/2014 2:00,Buy,11/17/2014 2:00,0.79501,0.79454,($5.70),"$10,758.30 ",-4.7,Neutral
950,11/17/2014 4:00,Buy,11/17/2014 4:00,0.79388,0.79128,($27.00),"$10,731.30 ",-26,Losing
951,11/17/2014 7:00,Buy,11/17/2014 7:00,0.79136,0.79194,$4.80 ,"$10,736.10 ",5.8,Winning
952,11/17/2014 8:00,Sell,11/17/2014 8:00,0.79194,0.79228,($4.40),"$10,731.70 ",-3.4,Neutral
953,11/19/2014 9:00,Sell,11/19/2014 9:00,0.78765,0.7861,$14.50 ,"$10,746.20 ",15.5,Winning
954,11/19/2014 18:00,Buy,11/19/2014 18:00,0.78412,0.78385,($3.70),"$10,742.50 ",-2.7,Neutral
955,11/24/2014 11:00,Sell,11/24/2014 11:00,0.78594,0.78531,$5.30 ,"$10,747.80 ",6.3,Winning
956,11/24/2014 22:00,Buy,11/24/2014 22:00,0.7815,0.78171,$1.10 ,"$10,748.90 ",2.1,Neutral
957,11/26/2014 11:00,Sell,11/26/2014 11:00,0.7887,0.78784,$7.60 ,"$10,756.50 ",8.6,Winning
958,11/26/2014 17:00,Buy,11/26/2014 17:00,0.78651,0.78719,$5.80 ,"$10,762.30 ",6.8,Winning
959,11/26/2014 20:00,Buy,11/26/2014 20:00,0.78626,0.78711,$7.50 ,"$10,769.80 ",8.5,Winning
960,11/27/2014 4:00,Buy,11/27/2014 4:00,0.78856,0.78887,$2.10 ,"$10,771.90 ",3.1,Neutral
961,11/27/2014 6:00,Buy,11/27/2014 6:00,0.78755,0.78887,$12.20 ,"$10,784.10 ",13.2,Winning
962,11/27/2014 10:00,Buy,11/27/2014 11:00,0.78742,0.78651,($10.10),"$10,774.00 ",-9.1,Losing
963,12/1/2014 0:00,Sell,12/1/2014 0:00,0.7823,0.78114,$10.60 ,"$10,784.60 ",11.6,Winning
964,12/1/2014 16:00,Buy,12/1/2014 16:00,0.78741,0.78567,($18.40),"$10,766.20 ",-17.4,Losing
965,12/2/2014 18:00,Sell,12/2/2014 18:00,0.77937,0.78001,($7.40),"$10,758.80 ",-6.4,Losing
966,12/4/2014 2:00,Buy,12/4/2014 2:00,0.77354,0.77378,$1.40 ,"$10,760.20 ",2.4,Neutral
967,12/4/2014 11:00,Sell,12/4/2014 11:00,0.77907,0.78083,($18.60),"$10,741.60 ",-17.6,Losing
968,12/7/2014 15:00,Buy,12/7/2014 15:00,0.76932,0.76936,($0.60),"$10,741.00 ",0.4,Neutral
969,12/7/2014 18:00,Buy,12/7/2014 18:00,0.76796,0.7676,($4.60),"$10,736.40 ",-3.6,Neutral
970,12/8/2014 17:00,Buy,12/8/2014 17:00,0.76472,0.766,$11.80 ,"$10,748.20 ",12.8,Winning
971,12/9/2014 15:00,Buy,12/9/2014 15:00,0.76847,0.76787,($7.00),"$10,741.20 ",-6,Losing
972,12/11/2014 0:00,Buy,12/11/2014 0:00,0.77981,0.78023,$3.20 ,"$10,744.40 ",4.2,Neutral
973,12/11/2014 5:00,Buy,12/11/2014 5:00,0.77842,0.7808,$22.80 ,"$10,767.20 ",23.8,Winning
974,12/11/2014 11:00,Buy,12/11/2014 11:00,0.77962,0.77991,$1.90 ,"$10,769.10 ",2.9,Neutral
975,12/16/2014 11:00,Buy,12/16/2014 11:00,0.7781,0.77845,$2.50 ,"$10,771.60 ",3.5,Neutral
976,12/16/2014 15:00,Buy,12/16/2014 15:00,0.77796,0.77878,$7.20 ,"$10,778.80 ",8.2,Winning
977,12/16/2014 18:00,Buy,12/16/2014 18:00,0.77781,0.77884,$9.30 ,"$10,788.10 ",10.3,Winning
978,12/16/2014 23:00,Buy,12/17/2014 2:00,0.77354,0.77243,($12.10),"$10,776.00 ",-11.1,Losing
979,12/17/2014 4:00,Sell,12/17/2014 4:00,0.77199,0.77223,($3.40),"$10,772.60 ",-2.4,Neutral
980,12/17/2014 7:00,Sell,12/17/2014 7:00,0.77405,0.77366,$2.90 ,"$10,775.50 ",3.9,Neutral
981,12/18/2014 14:00,Buy,12/18/2014 14:00,0.7732,0.77409,$7.90 ,"$10,783.40 ",8.9,Winning
982,12/19/2014 4:00,Buy,12/19/2014 6:00,0.77705,0.77749,$3.40 ,"$10,786.80 ",4.4,Neutral
983,12/19/2014 12:00,Buy,12/19/2014 14:00,0.77438,0.77482,$3.40 ,"$10,790.20 ",4.4,Neutral
984,12/19/2014 15:00,Sell,12/19/2014 15:00,0.77482,0.77456,$1.60 ,"$10,791.80 ",2.6,Neutral
985,12/23/2014 20:00,Sell,12/23/2014 20:00,0.77301,0.77196,$9.50 ,"$10,801.30 ",10.5,Winning
986,12/29/2014 5:00,Sell,12/29/2014 5:00,0.77974,0.77864,$10.00 ,"$10,811.30 ",11,Winning
987,12/30/2014 15:00,Buy,12/30/2014 16:00,0.78231,0.78282,$4.10 ,"$10,815.40 ",5.1,Winning
988,12/31/2014 2:00,Buy,12/31/2014 2:00,0.78271,0.78338,$5.70 ,"$10,821.10 ",6.7,Winning
989,1/1/2015 23:00,Buy,1/2/2015 0:00,0.77556,0.77537,($2.90),"$10,818.20 ",-1.9,Neutral
990,1/2/2015 2:00,Sell,1/2/2015 2:00,0.77569,0.77542,$1.70 ,"$10,819.90 ",2.7,Neutral
991,1/5/2015 11:00,Sell,1/5/2015 11:00,0.77005,0.77002,($0.70),"$10,819.20 ",0.3,Neutral
992,1/5/2015 17:00,Buy,1/5/2015 17:00,0.76815,0.76835,$1.00 ,"$10,820.20 ",2,Neutral
993,1/5/2015 20:00,Sell,1/5/2015 20:00,0.77112,0.77055,$4.70 ,"$10,824.90 ",5.7,Winning
994,1/6/2015 12:00,Sell,1/6/2015 12:00,0.78042,0.77905,$12.70 ,"$10,837.60 ",13.7,Winning
995,1/6/2015 16:00,Buy,1/6/2015 18:00,0.77707,0.77421,($29.60),"$10,808.00 ",-28.6,Losing
996,1/6/2015 20:00,Buy,1/6/2015 20:00,0.77377,0.77589,$20.20 ,"$10,828.20 ",21.2,Winning
997,1/7/2015 3:00,Sell,1/7/2015 3:00,0.77618,0.77553,$5.50 ,"$10,833.70 ",6.5,Winning
998,1/8/2015 6:00,Buy,1/8/2015 6:00,0.77855,0.77897,$3.20 ,"$10,836.90 ",4.2,Neutral
999,1/11/2015 16:00,Sell,1/11/2015 16:00,0.78448,0.78448,($1.00),"$10,835.90 ",0,Neutral
1000,1/12/2015 2:00,Buy,1/12/2015 2:00,0.78393,0.78311,($9.20),"$10,826.70 ",-8.2,Losing
1001,1/12/2015 4:00,Buy,1/12/2015 6:00,0.78076,0.77753,($33.30),"$10,793.40 ",-32.3,Losing
1002,1/12/2015 8:00,Buy,1/12/2015 8:00,0.77377,0.77524,$13.70 ,"$10,807.10 ",14.7,Winning
1003,1/12/2015 14:00,Sell,1/12/2015 14:00,0.77774,0.77744,$2.00 ,"$10,809.10 ",3,Neutral
1004,1/12/2015 16:00,Sell,1/12/2015 16:00,0.77822,0.77813,($0.10),"$10,809.00 ",0.9,Neutral
1005,1/13/2015 1:00,Buy,1/13/2015 1:00,0.77645,0.77684,$2.90 ,"$10,811.90 ",3.9,Neutral
1006,1/13/2015 5:00,Sell,1/13/2015 5:00,0.77541,0.77437,$9.40 ,"$10,821.30 ",10.4,Winning
1007,1/13/2015 7:00,Buy,1/13/2015 7:00,0.77371,0.77523,$14.20 ,"$10,835.50 ",15.2,Winning
1008,1/13/2015 9:00,Buy,1/13/2015 9:00,0.77233,0.77184,($5.90),"$10,829.60 ",-4.9,Neutral
1009,1/13/2015 19:00,Sell,1/13/2015 19:00,0.77404,0.77343,$5.10 ,"$10,834.70 ",6.1,Winning
1010,1/13/2015 21:00,Buy,1/13/2015 21:00,0.77268,0.7713,($14.80),"$10,819.90 ",-13.8,Losing
1011,1/14/2015 2:00,Buy,1/14/2015 2:00,0.76934,0.77271,$32.70 ,"$10,852.60 ",33.7,Winning
1012,1/14/2015 8:00,Buy,1/14/2015 8:00,0.77103,0.7762,$50.70 ,"$10,903.30 ",51.7,Winning
1013,1/14/2015 11:00,Sell,1/14/2015 11:00,0.773,0.77431,($14.10),"$10,889.20 ",-13.1,Losing
1014,1/15/2015 8:00,Sell,1/15/2015 8:00,0.78825,0.7842,$39.50 ,"$10,928.70 ",40.5,Winning
1015,1/20/2015 20:00,Buy,1/20/2015 20:00,0.76283,0.76471,$17.80 ,"$10,946.50 ",18.8,Winning
1016,1/21/2015 4:00,Buy,1/21/2015 4:00,0.76365,0.76331,($4.40),"$10,942.10 ",-3.4,Neutral
1017,1/21/2015 10:00,Sell,1/21/2015 10:00,0.77006,0.76135,$86.10 ,"$11,028.20 ",87.1,Winning
1018,1/21/2015 11:00,Buy,1/21/2015 17:00,0.76135,0.75656,($48.90),"$10,979.30 ",-47.9,Losing
1019,1/21/2015 22:00,Buy,1/21/2015 22:00,0.75266,0.75266,($1.00),"$10,978.30 ",0,Neutral
1020,1/22/2015 6:00,Sell,1/22/2015 6:00,0.7566,0.75742,($9.20),"$10,969.10 ",-8.2,Losing
1021,1/22/2015 9:00,Buy,1/22/2015 9:00,0.75355,0.75454,$8.90 ,"$10,978.00 ",9.9,Winning
1022,1/22/2015 16:00,Buy,1/22/2015 16:00,0.74877,0.75023,$13.60 ,"$10,991.60 ",14.6,Winning
1023,1/23/2015 0:00,Buy,1/23/2015 0:00,0.74912,0.749,($2.20),"$10,989.40 ",-1.2,Neutral
1024,1/23/2015 7:00,Buy,1/23/2015 7:00,0.74572,0.74411,($17.10),"$10,972.30 ",-16.1,Losing
1025,1/25/2015 18:00,Buy,1/25/2015 18:00,0.74154,0.74152,($1.20),"$10,971.10 ",-0.2,Neutral
1026,1/26/2015 9:00,Buy,1/26/2015 10:00,0.74273,0.74154,($12.90),"$10,958.20 ",-11.9,Losing
1027,1/28/2015 18:00,Buy,1/28/2015 19:00,0.73178,0.73406,$21.80 ,"$10,980.00 ",22.8,Winning
1028,2/2/2015 17:00,Buy,2/2/2015 17:00,0.72949,0.72975,$1.60 ,"$10,981.60 ",2.6,Neutral
1029,2/2/2015 23:00,Buy,2/3/2015 1:00,0.72027,0.72129,$9.20 ,"$10,990.80 ",10.2,Winning
1030,2/3/2015 3:00,Buy,2/3/2015 3:00,0.71924,0.71995,$6.10 ,"$10,996.90 ",7.1,Winning
1031,2/3/2015 9:00,Sell,2/3/2015 9:00,0.72509,0.72505,($0.60),"$10,996.30 ",0.4,Neutral
1032,2/3/2015 19:00,Buy,2/3/2015 19:00,0.73328,0.73843,$50.50 ,"$11,046.80 ",51.5,Winning
1033,2/4/2015 0:00,Sell,2/4/2015 0:00,0.74183,0.74347,($17.40),"$11,029.40 ",-16.4,Losing
1034,2/4/2015 5:00,Buy,2/4/2015 6:00,0.73833,0.73987,$14.40 ,"$11,043.80 ",15.4,Winning
1035,2/9/2015 6:00,Sell,2/9/2015 6:00,0.74181,0.74045,$12.60 ,"$11,056.40 ",13.6,Winning
1036,2/9/2015 22:00,Sell,2/9/2015 22:00,0.74371,0.74346,$1.50 ,"$11,057.90 ",2.5,Neutral
1037,2/11/2015 20:00,Sell,2/11/2015 20:00,0.73504,0.73491,$0.30 ,"$11,058.20 ",1.3,Neutral
1038,2/11/2015 22:00,Buy,2/11/2015 22:00,0.73374,0.7344,$5.60 ,"$11,063.80 ",6.6,Winning
1039,2/12/2015 3:00,Buy,2/12/2015 3:00,0.73323,0.73399,$6.60 ,"$11,070.40 ",7.6,Winning
1040,2/12/2015 17:00,Buy,2/12/2015 17:00,0.74219,0.74197,($3.20),"$11,067.20 ",-2.2,Neutral
1041,2/12/2015 20:00,Sell,2/12/2015 20:00,0.74228,0.74275,($5.70),"$11,061.50 ",-4.7,Neutral
1042,2/13/2015 5:00,Buy,2/13/2015 6:00,0.74269,0.7429,$1.10 ,"$11,062.60 ",2.1,Neutral
1043,2/16/2015 9:00,Buy,2/16/2015 11:00,0.75078,0.74978,($11.00),"$11,051.60 ",-10,Losing
1044,2/16/2015 13:00,Sell,2/16/2015 13:00,0.74961,0.74835,$11.60 ,"$11,063.20 ",12.6,Winning
1045,2/16/2015 14:00,Buy,2/16/2015 14:00,0.74835,0.74939,$9.40 ,"$11,072.60 ",10.4,Winning
1046,2/16/2015 18:00,Sell,2/16/2015 18:00,0.74908,0.74844,$5.40 ,"$11,078.00 ",6.4,Winning
1047,2/16/2015 22:00,Sell,2/16/2015 22:00,0.75246,0.75166,$7.00 ,"$11,085.00 ",8,Winning
1048,2/17/2015 6:00,Sell,2/17/2015 6:00,0.75354,0.7533,$1.40 ,"$11,086.40 ",2.4,Neutral
1049,2/24/2015 5:00,Buy,2/24/2015 5:00,0.74374,0.7451,$12.60 ,"$11,099.00 ",13.6,Winning
1050,2/24/2015 7:00,Sell,2/24/2015 7:00,0.74452,0.74465,($2.30),"$11,096.70 ",-1.3,Neutral
1051,2/24/2015 17:00,Sell,2/24/2015 17:00,0.74898,0.74864,$2.40 ,"$11,099.10 ",3.4,Neutral
1052,2/26/2015 3:00,Sell,2/26/2015 3:00,0.75732,0.75924,($20.20),"$11,078.90 ",-19.2,Losing
1053,2/26/2015 9:00,Buy,2/26/2015 10:00,0.75555,0.75454,($11.10),"$11,067.80 ",-10.1,Losing
1054,2/26/2015 12:00,Sell,2/26/2015 12:00,0.75526,0.75431,$8.50 ,"$11,076.30 ",9.5,Winning
1055,2/26/2015 14:00,Buy,2/26/2015 14:00,0.75311,0.75225,($9.60),"$11,066.70 ",-8.6,Losing
1056,2/26/2015 17:00,Sell,2/26/2015 18:00,0.75279,0.75362,($9.30),"$11,057.40 ",-8.3,Losing
1057,3/2/2015 2:00,Sell,3/2/2015 2:00,0.75269,0.7519,$6.90 ,"$11,064.30 ",7.9,Winning
1058,3/2/2015 5:00,Sell,3/2/2015 5:00,0.75368,0.75286,$7.20 ,"$11,071.50 ",8.2,Winning
1059,3/2/2015 16:00,Sell,3/2/2015 16:00,0.75086,0.75045,$3.10 ,"$11,074.60 ",4.1,Neutral
1060,3/2/2015 17:00,Buy,3/2/2015 17:00,0.75045,0.75013,($4.20),"$11,070.40 ",-3.2,Neutral
1061,3/3/2015 1:00,Sell,3/3/2015 1:00,0.75438,0.75389,$3.90 ,"$11,074.30 ",4.9,Neutral
1062,3/3/2015 5:00,Buy,3/3/2015 6:00,0.7533,0.75349,$0.90 ,"$11,075.20 ",1.9,Neutral
1063,3/3/2015 15:00,Buy,3/3/2015 17:00,0.75471,0.75475,($0.60),"$11,074.60 ",0.4,Neutral
1064,3/4/2015 5:00,Sell,3/4/2015 5:00,0.75844,0.75859,($2.50),"$11,072.10 ",-1.5,Neutral
1065,3/4/2015 10:00,Buy,3/4/2015 10:00,0.75802,0.7578,($3.20),"$11,068.90 ",-2.2,Neutral
1066,3/4/2015 16:00,Sell,3/4/2015 16:00,0.76024,0.75815,$19.90 ,"$11,088.80 ",20.9,Winning
1067,3/4/2015 17:00,Buy,3/4/2015 17:00,0.75815,0.75827,$0.20 ,"$11,089.00 ",1.2,Neutral
1068,3/4/2015 21:00,Buy,3/4/2015 21:00,0.75718,0.75511,($21.70),"$11,067.30 ",-20.7,Losing
1069,3/5/2015 0:00,Buy,3/5/2015 5:00,0.75517,0.75208,($31.90),"$11,035.40 ",-30.9,Losing
1070,3/5/2015 6:00,Sell,3/5/2015 6:00,0.75208,0.75112,$8.60 ,"$11,044.00 ",9.6,Winning
1071,3/5/2015 7:00,Buy,3/5/2015 7:00,0.75112,0.74938,($18.40),"$11,025.60 ",-17.4,Losing
1072,3/5/2015 10:00,Buy,3/5/2015 10:00,0.74822,0.74771,($6.10),"$11,019.50 ",-5.1,Losing
1073,3/5/2015 12:00,Buy,3/5/2015 12:00,0.74631,0.74593,($4.80),"$11,014.70 ",-3.8,Neutral
1074,3/6/2015 1:00,Buy,3/6/2015 2:00,0.74726,0.74683,($5.30),"$11,009.40 ",-4.3,Neutral
1075,3/6/2015 8:00,Sell,3/6/2015 8:00,0.7494,0.74156,$77.40 ,"$11,086.80 ",78.4,Winning
1076,3/6/2015 9:00,Buy,3/6/2015 14:00,0.74156,0.73692,($47.40),"$11,039.40 ",-46.4,Losing
1077,3/10/2015 2:00,Sell,3/10/2015 2:00,0.72959,0.73101,($15.20),"$11,024.20 ",-14.2,Losing
1078,3/10/2015 23:00,Buy,3/11/2015 0:00,0.72426,0.72461,$2.50 ,"$11,026.70 ",3.5,Neutral
1079,3/11/2015 2:00,Sell,3/11/2015 2:00,0.72463,0.7254,($8.70),"$11,018.00 ",-7.7,Losing
1080,3/11/2015 21:00,Sell,3/11/2015 21:00,0.73164,0.73137,$1.70 ,"$11,019.70 ",2.7,Neutral
1081,3/13/2015 0:00,Buy,3/13/2015 1:00,0.73765,0.73694,($8.10),"$11,011.60 ",-7.1,Losing
1082,3/13/2015 3:00,Buy,3/13/2015 3:00,0.73576,0.7373,$14.40 ,"$11,026.00 ",15.4,Winning
1083,3/13/2015 5:00,Sell,3/13/2015 5:00,0.73612,0.73352,$25.00 ,"$11,051.00 ",26,Winning
1084,3/13/2015 6:00,Buy,3/13/2015 6:00,0.73352,0.73314,($4.80),"$11,046.20 ",-3.8,Neutral
1085,3/13/2015 11:00,Sell,3/13/2015 11:00,0.73296,0.73281,$0.50 ,"$11,046.70 ",1.5,Neutral
1086,3/16/2015 13:00,Sell,3/16/2015 13:00,0.74044,0.73903,$13.10 ,"$11,059.80 ",14.1,Winning
1087,3/16/2015 16:00,Buy,3/16/2015 17:00,0.73752,0.73696,($6.60),"$11,053.20 ",-5.6,Losing
1088,3/17/2015 17:00,Sell,3/17/2015 17:00,0.73033,0.73158,($13.50),"$11,039.70 ",-12.5,Losing
1089,3/18/2015 2:00,Buy,3/18/2015 2:00,0.7294,0.73013,$6.30 ,"$11,046.00 ",7.3,Winning
1090,3/19/2015 14:00,Sell,3/19/2015 14:00,0.73823,0.73797,$1.60 ,"$11,047.60 ",2.6,Neutral
1091,3/23/2015 20:00,Buy,3/23/2015 21:00,0.7651,0.76403,($11.70),"$11,035.90 ",-10.7,Losing
1092,3/24/2015 0:00,Buy,3/24/2015 0:00,0.76279,0.76543,$25.40 ,"$11,061.30 ",26.4,Winning
1093,3/24/2015 6:00,Buy,3/24/2015 6:00,0.76393,0.76668,$26.50 ,"$11,087.80 ",27.5,Winning
1094,3/24/2015 20:00,Buy,3/24/2015 20:00,0.76237,0.76363,$11.60 ,"$11,099.40 ",12.6,Winning
1095,3/30/2015 7:00,Sell,3/30/2015 7:00,0.75227,0.75122,$9.50 ,"$11,108.90 ",10.5,Winning
1096,3/30/2015 11:00,Sell,3/30/2015 11:00,0.75144,0.75108,$2.60 ,"$11,111.50 ",3.6,Neutral
1097,3/30/2015 16:00,Buy,3/30/2015 16:00,0.74879,0.74894,$0.50 ,"$11,112.00 ",1.5,Neutral
1098,3/30/2015 18:00,Buy,3/30/2015 18:00,0.74912,0.74948,$2.60 ,"$11,114.60 ",3.6,Neutral
1099,3/30/2015 19:00,Sell,3/30/2015 19:00,0.74948,0.74968,($3.00),"$11,111.60 ",-2,Neutral
1100,3/31/2015 0:00,Buy,3/31/2015 0:00,0.74782,0.74855,$6.30 ,"$11,117.90 ",7.3,Winning
1101,3/31/2015 3:00,Sell,3/31/2015 3:00,0.7483,0.74657,$16.30 ,"$11,134.20 ",17.3,Winning
1102,3/31/2015 11:00,Sell,3/31/2015 11:00,0.74985,0.74834,$14.10 ,"$11,148.30 ",15.1,Winning
1103,4/6/2015 6:00,Buy,4/6/2015 6:00,0.75932,0.75922,($2.00),"$11,146.30 ",-1,Neutral
1104,4/6/2015 11:00,Sell,4/6/2015 11:00,0.76141,0.76017,$11.40 ,"$11,157.70 ",12.4,Winning
1105,4/6/2015 14:00,Buy,4/6/2015 15:00,0.75781,0.75534,($25.70),"$11,132.00 ",-24.7,Losing
1106,4/6/2015 17:00,Sell,4/6/2015 17:00,0.7539,0.75455,($7.50),"$11,124.50 ",-6.5,Losing
1107,4/7/2015 5:00,Buy,4/7/2015 5:00,0.75193,0.75452,$24.90 ,"$11,149.40 ",25.9,Winning
1108,4/7/2015 16:00,Buy,4/7/2015 16:00,0.7492,0.74907,($2.30),"$11,147.10 ",-1.3,Neutral
1109,4/7/2015 20:00,Sell,4/7/2015 20:00,0.75054,0.7516,($11.60),"$11,135.50 ",-10.6,Losing
1110,4/9/2015 8:00,Sell,4/9/2015 8:00,0.76016,0.75858,$14.80 ,"$11,150.30 ",15.8,Winning
1111,4/10/2015 9:00,Sell,4/10/2015 9:00,0.75255,0.75442,($19.70),"$11,130.60 ",-18.7,Losing
1112,4/13/2015 3:00,Sell,4/13/2015 3:00,0.74695,0.74435,$25.00 ,"$11,155.60 ",26,Winning
1113,4/13/2015 4:00,Buy,4/13/2015 5:00,0.74435,0.74433,($1.20),"$11,154.40 ",-0.2,Neutral
1114,4/13/2015 7:00,Buy,4/13/2015 7:00,0.74293,0.74343,$4.00 ,"$11,158.40 ",5,Winning
1115,4/13/2015 16:00,Sell,4/13/2015 16:00,0.74568,0.74519,$3.90 ,"$11,162.30 ",4.9,Neutral
1116,4/13/2015 21:00,Sell,4/13/2015 21:00,0.74704,0.74689,$0.50 ,"$11,162.80 ",1.5,Neutral
1117,4/14/2015 16:00,Buy,4/14/2015 17:00,0.75173,0.75187,$0.40 ,"$11,163.20 ",1.4,Neutral
1118,4/14/2015 19:00,Buy,4/14/2015 19:00,0.7511,0.75089,($3.10),"$11,160.10 ",-2.1,Neutral
1119,4/15/2015 4:00,Buy,4/15/2015 4:00,0.75136,0.74999,($14.70),"$11,145.40 ",-13.7,Losing
1120,4/16/2015 20:00,Buy,4/16/2015 20:00,0.76492,0.76671,$16.90 ,"$11,162.30 ",17.9,Winning
1121,4/16/2015 22:00,Buy,4/16/2015 22:00,0.76461,0.76487,$1.60 ,"$11,163.90 ",2.6,Neutral
1122,4/19/2015 15:00,Buy,4/19/2015 15:00,0.76715,0.76984,$25.90 ,"$11,189.80 ",26.9,Winning
1123,4/20/2015 10:00,Sell,4/20/2015 10:00,0.76806,0.76627,$16.90 ,"$11,206.70 ",17.9,Winning
1124,4/20/2015 22:00,Buy,4/20/2015 22:00,0.76349,0.76455,$9.60 ,"$11,216.30 ",10.6,Winning
1125,4/21/2015 10:00,Buy,4/21/2015 10:00,0.7671,0.7696,$24.00 ,"$11,240.30 ",25,Winning
1126,4/22/2015 16:00,Sell,4/22/2015 16:00,0.76643,0.7664,($0.70),"$11,239.60 ",0.3,Neutral
1127,4/23/2015 0:00,Sell,4/23/2015 0:00,0.75863,0.7582,$3.30 ,"$11,242.90 ",4.3,Neutral
1128,4/24/2015 6:00,Buy,4/24/2015 6:00,0.75584,0.75555,($3.90),"$11,239.00 ",-2.9,Neutral
1129,4/27/2015 3:00,Buy,4/27/2015 3:00,0.76062,0.76045,($2.70),"$11,236.30 ",-1.7,Neutral
1130,4/27/2015 5:00,Buy,4/27/2015 5:00,0.75976,0.76058,$7.20 ,"$11,243.50 ",8.2,Winning
1131,4/27/2015 18:00,Buy,4/27/2015 18:00,0.76352,0.76366,$0.40 ,"$11,243.90 ",1.4,Neutral
1132,4/27/2015 23:00,Sell,4/27/2015 23:00,0.76291,0.76242,$3.90 ,"$11,247.80 ",4.9,Neutral
1133,4/28/2015 5:00,Sell,4/28/2015 5:00,0.76683,0.76794,($12.10),"$11,235.70 ",-11.1,Losing
1134,4/28/2015 7:00,Sell,4/28/2015 7:00,0.76901,0.76883,$0.80 ,"$11,236.50 ",1.8,Neutral
1135,4/28/2015 17:00,Buy,4/28/2015 17:00,0.77098,0.7731,$20.20 ,"$11,256.70 ",21.2,Winning
1136,4/29/2015 1:00,Buy,4/29/2015 1:00,0.76922,0.76999,$6.70 ,"$11,263.40 ",7.7,Winning
1137,4/29/2015 3:00,Sell,4/29/2015 3:00,0.77146,0.77085,$5.10 ,"$11,268.50 ",6.1,Winning
1138,4/29/2015 20:00,Buy,4/29/2015 20:00,0.76042,0.76234,$18.20 ,"$11,286.70 ",19.2,Winning
1139,4/29/2015 21:00,Sell,4/29/2015 22:00,0.76234,0.76168,$5.60 ,"$11,292.30 ",6.6,Winning
1140,4/30/2015 15:00,Sell,4/30/2015 15:00,0.76285,0.76328,($5.30),"$11,287.00 ",-4.3,Neutral
1141,5/1/2015 14:00,Sell,5/1/2015 14:00,0.75301,0.75184,$10.70 ,"$11,297.70 ",11.7,Winning
1142,5/5/2015 23:00,Sell,5/5/2015 23:00,0.74904,0.74866,$2.80 ,"$11,300.50 ",3.8,Neutral
1143,5/11/2015 19:00,Buy,5/11/2015 19:00,0.73335,0.7341,$6.50 ,"$11,307.00 ",7.5,Winning
1144,5/11/2015 22:00,Sell,5/11/2015 22:00,0.73462,0.73597,($14.50),"$11,292.50 ",-13.5,Losing
1145,5/12/2015 6:00,Sell,5/12/2015 6:00,0.73775,0.73815,($5.00),"$11,287.50 ",-4,Neutral
1146,5/14/2015 14:00,Buy,5/14/2015 14:00,0.74937,0.7496,$1.30 ,"$11,288.80 ",2.3,Neutral
1147,5/14/2015 21:00,Buy,5/14/2015 21:00,0.74594,0.7472,$11.60 ,"$11,300.40 ",12.6,Winning
1148,5/15/2015 6:00,Buy,5/15/2015 6:00,0.74428,0.74409,($2.90),"$11,297.50 ",-1.9,Neutral
1149,5/15/2015 8:00,Buy,5/15/2015 9:00,0.74367,0.74376,($0.10),"$11,297.40 ",0.9,Neutral
1150,5/15/2015 12:00,Sell,5/15/2015 12:00,0.74872,0.74783,$7.90 ,"$11,305.30 ",8.9,Winning
1151,5/18/2015 9:00,Buy,5/18/2015 9:00,0.73982,0.73834,($15.80),"$11,289.50 ",-14.8,Losing
1152,5/18/2015 14:00,Buy,5/18/2015 14:00,0.73753,0.73808,$4.50 ,"$11,294.00 ",5.5,Winning
1153,5/19/2015 2:00,Sell,5/19/2015 2:00,0.74398,0.74168,$22.00 ,"$11,316.00 ",23,Winning
1154,5/19/2015 13:00,Buy,5/19/2015 14:00,0.73412,0.73474,$5.20 ,"$11,321.20 ",6.2,Winning
1155,5/19/2015 15:00,Sell,5/19/2015 15:00,0.73474,0.73382,$8.20 ,"$11,329.40 ",9.2,Winning
1156,5/19/2015 16:00,Buy,5/19/2015 16:00,0.73382,0.73415,$2.30 ,"$11,331.70 ",3.3,Neutral
1157,5/19/2015 20:00,Sell,5/19/2015 20:00,0.73584,0.73504,$7.00 ,"$11,338.70 ",8,Winning
1158,5/22/2015 9:00,Buy,5/22/2015 9:00,0.73163,0.73139,($3.40),"$11,335.30 ",-2.4,Neutral
1159,5/22/2015 12:00,Buy,5/22/2015 12:00,0.73044,0.73135,$8.10 ,"$11,343.40 ",9.1,Winning
1160,5/22/2015 15:00,Sell,5/22/2015 15:00,0.73054,0.73064,($2.00),"$11,341.40 ",-1,Neutral
1161,5/24/2015 15:00,Buy,5/24/2015 15:00,0.7299,0.73123,$12.30 ,"$11,353.70 ",13.3,Winning
1162,5/24/2015 18:00,Sell,5/24/2015 18:00,0.73048,0.73095,($5.70),"$11,348.00 ",-4.7,Neutral
1163,5/26/2015 15:00,Buy,5/26/2015 16:00,0.72283,0.72196,($9.70),"$11,338.30 ",-8.7,Losing
1164,5/26/2015 19:00,Sell,5/26/2015 19:00,0.72456,0.7242,$2.60 ,"$11,340.90 ",3.6,Neutral
1165,5/27/2015 4:00,Buy,5/27/2015 4:00,0.72438,0.72465,$1.70 ,"$11,342.60 ",2.7,Neutral
1166,5/27/2015 6:00,Buy,5/27/2015 6:00,0.7238,0.72289,($10.10),"$11,332.50 ",-9.1,Losing
1167,5/28/2015 11:00,Sell,5/28/2015 11:00,0.71581,0.71485,$8.60 ,"$11,341.10 ",9.6,Winning
1168,5/28/2015 15:00,Sell,5/28/2015 15:00,0.71834,0.71733,$9.10 ,"$11,350.20 ",10.1,Winning
1169,5/28/2015 22:00,Buy,5/29/2015 1:00,0.7146,0.71442,($2.80),"$11,347.40 ",-1.8,Neutral
1170,5/29/2015 2:00,Sell,5/29/2015 2:00,0.71442,0.71211,$22.10 ,"$11,369.50 ",23.1,Winning
1171,5/29/2015 3:00,Buy,5/29/2015 3:00,0.71211,0.71288,$6.70 ,"$11,376.20 ",7.7,Winning
1172,6/1/2015 11:00,Buy,6/1/2015 13:00,0.7103,0.70861,($17.90),"$11,358.30 ",-16.9,Losing
1173,6/1/2015 15:00,Buy,6/1/2015 15:00,0.70882,0.70876,($1.60),"$11,356.70 ",-0.6,Neutral
1174,6/1/2015 16:00,Sell,6/1/2015 16:00,0.70876,0.70867,($0.10),"$11,356.60 ",0.9,Neutral
1175,6/2/2015 20:00,Buy,6/2/2015 20:00,0.71602,0.71632,$2.00 ,"$11,358.60 ",3,Neutral
1176,6/2/2015 22:00,Sell,6/2/2015 22:00,0.71915,0.71724,$18.10 ,"$11,376.70 ",19.1,Winning
1177,6/3/2015 5:00,Buy,6/3/2015 5:00,0.71447,0.71426,($3.10),"$11,373.60 ",-2.1,Neutral
1178,6/5/2015 15:00,Sell,6/5/2015 15:00,0.70393,0.70418,($3.50),"$11,370.10 ",-2.5,Neutral
1179,6/7/2015 18:00,Sell,6/7/2015 18:00,0.70482,0.70467,$0.50 ,"$11,370.60 ",1.5,Neutral
1180,6/8/2015 9:00,Sell,6/8/2015 9:00,0.70871,0.70877,($1.60),"$11,369.00 ",-0.6,Neutral
1181,6/8/2015 21:00,Buy,6/8/2015 21:00,0.71193,0.71247,$4.40 ,"$11,373.40 ",5.4,Winning
1182,6/9/2015 0:00,Buy,6/9/2015 0:00,0.71158,0.71091,($7.70),"$11,365.70 ",-6.7,Losing
1183,6/9/2015 7:00,Sell,6/9/2015 7:00,0.71397,0.7154,($15.30),"$11,350.40 ",-14.3,Losing
1184,6/14/2015 15:00,Buy,6/14/2015 15:00,0.69787,0.69911,$11.40 ,"$11,361.80 ",12.4,Winning
1185,6/15/2015 1:00,Sell,6/15/2015 1:00,0.6968,0.69672,($0.20),"$11,361.60 ",0.8,Neutral
1186,6/17/2015 7:00,Buy,6/17/2015 7:00,0.69267,0.6928,$0.30 ,"$11,361.90 ",1.3,Neutral
1187,6/17/2015 11:00,Buy,6/17/2015 11:00,0.6909,0.69101,$0.10 ,"$11,362.00 ",1.1,Neutral
1188,6/17/2015 20:00,Buy,6/17/2015 20:00,0.68857,0.6897,$10.30 ,"$11,372.30 ",11.3,Winning
1189,6/18/2015 2:00,Buy,6/18/2015 2:00,0.68912,0.68947,$2.50 ,"$11,374.80 ",3.5,Neutral
1190,6/18/2015 6:00,Sell,6/18/2015 6:00,0.6957,0.69352,$20.80 ,"$11,395.60 ",21.8,Winning
1191,6/18/2015 8:00,Sell,6/18/2015 8:00,0.69601,0.69569,$2.20 ,"$11,397.80 ",3.2,Neutral
1192,6/18/2015 11:00,Buy,6/18/2015 11:00,0.69351,0.69392,$3.10 ,"$11,400.90 ",4.1,Neutral
1193,6/23/2015 10:00,Sell,6/23/2015 10:00,0.68264,0.68453,($19.90),"$11,381.00 ",-18.9,Losing
1194,6/24/2015 10:00,Buy,6/24/2015 10:00,0.68634,0.68582,($6.20),"$11,374.80 ",-5.2,Losing
1195,6/24/2015 18:00,Buy,6/24/2015 18:00,0.68806,0.68857,$4.10 ,"$11,378.90 ",5.1,Winning
1196,6/24/2015 21:00,Sell,6/24/2015 21:00,0.69034,0.69013,$1.10 ,"$11,380.00 ",2.1,Neutral
1197,6/25/2015 0:00,Sell,6/25/2015 0:00,0.6921,0.69164,$3.60 ,"$11,383.60 ",4.6,Neutral
1198,6/25/2015 4:00,Buy,6/25/2015 5:00,0.68912,0.69049,$12.70 ,"$11,396.30 ",13.7,Winning
1199,6/26/2015 8:00,Buy,6/26/2015 9:00,0.68499,0.68475,($3.40),"$11,392.90 ",-2.4,Neutral
1200,6/29/2015 11:00,Buy,6/29/2015 11:00,0.68102,0.68514,$40.20 ,"$11,433.10 ",41.2,Winning
1201,6/29/2015 13:00,Sell,6/29/2015 13:00,0.68582,0.68711,($13.90),"$11,419.20 ",-12.9,Losing
1202,6/29/2015 22:00,Sell,6/29/2015 22:00,0.68207,0.68063,$13.40 ,"$11,432.60 ",14.4,Winning
1203,6/30/2015 0:00,Sell,6/30/2015 0:00,0.68143,0.68079,$5.40 ,"$11,438.00 ",6.4,Winning
1204,6/30/2015 6:00,Buy,6/30/2015 8:00,0.67573,0.67771,$18.80 ,"$11,456.80 ",19.8,Winning
1205,6/30/2015 17:00,Buy,6/30/2015 17:00,0.67621,0.67719,$8.80 ,"$11,465.60 ",9.8,Winning
1206,7/1/2015 9:00,Sell,7/1/2015 9:00,0.67625,0.67551,$6.40 ,"$11,472.00 ",7.4,Winning
1207,7/1/2015 11:00,Sell,7/1/2015 11:00,0.67463,0.67513,($6.00),"$11,466.00 ",-5,Losing
1208,7/1/2015 17:00,Buy,7/1/2015 17:00,0.67309,0.67327,$0.80 ,"$11,466.80 ",1.8,Neutral
1209,7/1/2015 20:00,Buy,7/1/2015 20:00,0.67111,0.6709,($3.10),"$11,463.70 ",-2.1,Neutral
1210,7/2/2015 17:00,Buy,7/2/2015 17:00,0.67159,0.67197,$2.80 ,"$11,466.50 ",3.8,Neutral
1211,7/2/2015 22:00,Buy,7/2/2015 22:00,0.67164,0.67179,$0.50 ,"$11,467.00 ",1.5,Neutral
1212,7/9/2015 4:00,Buy,7/9/2015 5:00,0.67186,0.67117,($7.90),"$11,459.10 ",-6.9,Losing
1213,7/9/2015 13:00,Buy,7/9/2015 13:00,0.67212,0.67219,($0.30),"$11,458.80 ",0.7,Neutral
1214,7/10/2015 16:00,Sell,7/10/2015 16:00,0.67216,0.6714,$6.60 ,"$11,465.40 ",7.6,Winning
1215,7/12/2015 16:00,Buy,7/12/2015 16:00,0.66913,0.6696,$3.70 ,"$11,469.10 ",4.7,Neutral
1216,7/12/2015 21:00,Sell,7/12/2015 21:00,0.67175,0.67147,$1.80 ,"$11,470.90 ",2.8,Neutral
1217,7/12/2015 23:00,Sell,7/12/2015 23:00,0.67346,0.67309,$2.70 ,"$11,473.60 ",3.7,Neutral
1218,7/15/2015 13:00,Buy,7/15/2015 14:00,0.65957,0.65941,($2.60),"$11,471.00 ",-1.6,Neutral
1219,7/17/2015 4:00,Buy,7/17/2015 4:00,0.65296,0.65314,$0.80 ,"$11,471.80 ",1.8,Neutral
1220,7/17/2015 16:00,Sell,7/17/2015 16:00,0.6527,0.65121,$13.90 ,"$11,485.70 ",14.9,Winning
1221,7/20/2015 3:00,Sell,7/20/2015 3:00,0.65941,0.65838,$9.30 ,"$11,495.00 ",10.3,Winning
1222,7/20/2015 17:00,Buy,7/20/2015 17:00,0.65559,0.65585,$1.60 ,"$11,496.60 ",2.6,Neutral
1223,7/21/2015 3:00,Sell,7/21/2015 3:00,0.66041,0.66001,$3.00 ,"$11,499.60 ",4,Neutral
1224,7/21/2015 17:00,Buy,7/21/2015 17:00,0.6616,0.66217,$4.70 ,"$11,504.30 ",5.7,Winning
1225,7/22/2015 15:00,Sell,7/22/2015 15:00,0.65847,0.65832,$0.50 ,"$11,504.80 ",1.5,Neutral
1226,7/23/2015 22:00,Sell,7/23/2015 22:00,0.65958,0.65817,$13.10 ,"$11,517.90 ",14.1,Winning
1227,7/24/2015 6:00,Buy,7/24/2015 6:00,0.65707,0.6576,$4.30 ,"$11,522.20 ",5.3,Winning
1228,7/24/2015 8:00,Buy,7/24/2015 8:00,0.65622,0.65756,$12.40 ,"$11,534.60 ",13.4,Winning
1229,7/26/2015 17:00,Buy,7/26/2015 17:00,0.65629,0.65706,$6.70 ,"$11,541.30 ",7.7,Winning
1230,7/27/2015 15:00,Buy,7/27/2015 15:00,0.66107,0.66061,($5.60),"$11,535.70 ",-4.6,Neutral
1231,7/27/2015 20:00,Sell,7/27/2015 20:00,0.66255,0.66408,($16.30),"$11,519.40 ",-15.3,Losing
1232,7/29/2015 10:00,Sell,7/29/2015 10:00,0.66916,0.66776,$13.00 ,"$11,532.40 ",14,Winning
1233,7/29/2015 21:00,Sell,7/29/2015 22:00,0.664,0.6637,$2.00 ,"$11,534.40 ",3,Neutral
1234,7/30/2015 8:00,Buy,7/30/2015 8:00,0.66048,0.66023,($3.50),"$11,530.90 ",-2.5,Neutral
1235,7/31/2015 14:00,Buy,7/31/2015 15:00,0.66065,0.65988,($8.70),"$11,522.20 ",-7.7,Losing
1236,8/2/2015 15:00,Buy,8/2/2015 15:00,0.65871,0.65885,$0.40 ,"$11,522.60 ",1.4,Neutral
1237,8/2/2015 16:00,Sell,8/2/2015 16:00,0.65885,0.66024,($14.90),"$11,507.70 ",-13.9,Losing
1238,8/2/2015 19:00,Sell,8/2/2015 19:00,0.659,0.65785,$10.50 ,"$11,518.20 ",11.5,Winning
1239,8/2/2015 23:00,Sell,8/2/2015 23:00,0.65815,0.6583,($2.50),"$11,515.70 ",-1.5,Neutral
1240,8/4/2015 5:00,Sell,8/4/2015 5:00,0.6606,0.66031,$1.90 ,"$11,517.60 ",2.9,Neutral
1241,8/4/2015 19:00,Sell,8/4/2015 19:00,0.65326,0.65345,($2.90),"$11,514.70 ",-1.9,Neutral
1242,8/7/2015 8:00,Sell,8/7/2015 8:00,0.65745,0.65295,$44.00 ,"$11,558.70 ",45,Winning
1243,8/9/2015 16:00,Buy,8/9/2015 16:00,0.66019,0.66099,$7.00 ,"$11,565.70 ",8,Winning
1244,8/9/2015 20:00,Sell,8/9/2015 20:00,0.6604,0.66027,$0.30 ,"$11,566.00 ",1.3,Neutral
1245,8/10/2015 4:00,Buy,8/10/2015 5:00,0.65911,0.65631,($29.00),"$11,537.00 ",-28,Losing
1246,8/10/2015 7:00,Buy,8/10/2015 7:00,0.65608,0.65771,$15.30 ,"$11,552.30 ",16.3,Winning
1247,8/10/2015 12:00,Sell,8/10/2015 12:00,0.66,0.66183,($19.30),"$11,533.00 ",-18.3,Losing
1248,8/13/2015 11:00,Sell,8/13/2015 11:00,0.65572,0.65699,($13.70),"$11,519.30 ",-12.7,Losing
1249,8/18/2015 3:00,Buy,8/18/2015 3:00,0.65845,0.65795,($6.00),"$11,513.30 ",-5,Neutral
1250,8/20/2015 4:00,Buy,8/20/2015 5:00,0.65943,0.6587,($8.30),"$11,505.00 ",-7.3,Losing
1251,8/20/2015 17:00,Buy,8/20/2015 17:00,0.66222,0.6626,$2.80 ,"$11,507.80 ",3.8,Neutral
1252,8/20/2015 19:00,Buy,8/20/2015 19:00,0.662,0.66207,($0.30),"$11,507.50 ",0.7,Neutral
1253,8/21/2015 0:00,Sell,8/21/2015 0:00,0.66121,0.66239,($12.80),"$11,494.70 ",-11.8,Losing
1254,8/23/2015 15:00,Buy,8/23/2015 16:00,0.66779,0.66568,($22.10),"$11,472.60 ",-21.1,Losing
1255,8/23/2015 19:00,Buy,8/23/2015 19:00,0.66411,0.66252,($16.90),"$11,455.70 ",-15.9,Losing
1256,8/23/2015 23:00,Buy,8/23/2015 23:00,0.65858,0.65914,$4.60 ,"$11,460.30 ",5.6,Winning
1257,8/24/2015 5:00,Buy,8/24/2015 6:00,0.65892,0.65682,($22.00),"$11,438.30 ",-21,Losing
1258,8/25/2015 11:00,Buy,8/25/2015 11:00,0.6515,0.65182,$2.20 ,"$11,440.50 ",3.2,Neutral
1259,8/25/2015 16:00,Buy,8/25/2015 16:00,0.64788,0.64692,($10.60),"$11,429.90 ",-9.6,Losing
1260,8/25/2015 18:00,Sell,8/25/2015 18:00,0.64849,0.64811,$2.80 ,"$11,432.70 ",3.8,Neutral
1261,8/25/2015 20:00,Buy,8/25/2015 20:00,0.64665,0.64785,$11.00 ,"$11,443.70 ",12,Winning
1262,8/26/2015 11:00,Buy,8/26/2015 13:00,0.64282,0.64231,($6.10),"$11,437.60 ",-5.1,Losing
1263,8/26/2015 15:00,Buy,8/26/2015 15:00,0.6415,0.64301,$14.10 ,"$11,451.70 ",15.1,Winning
1264,8/31/2015 9:00,Buy,8/31/2015 9:00,0.6383,0.63668,($17.20),"$11,434.50 ",-16.2,Losing
1265,9/1/2015 4:00,Buy,9/1/2015 5:00,0.63695,0.63344,($36.10),"$11,398.40 ",-35.1,Losing
1266,9/1/2015 17:00,Buy,9/1/2015 17:00,0.63245,0.63349,$9.40 ,"$11,407.80 ",10.4,Winning
1267,9/2/2015 0:00,Sell,9/2/2015 0:00,0.63657,0.63624,$2.30 ,"$11,410.10 ",3.3,Neutral
1268,9/4/2015 14:00,Sell,9/4/2015 14:00,0.62887,0.63003,($12.60),"$11,397.50 ",-11.6,Losing
1269,9/6/2015 15:00,Buy,9/6/2015 15:00,0.62776,0.62907,$12.10 ,"$11,409.60 ",13.1,Winning
1270,9/7/2015 7:00,Buy,9/7/2015 7:00,0.62581,0.62569,($2.20),"$11,407.40 ",-1.2,Neutral
1271,9/8/2015 17:00,Buy,9/8/2015 18:00,0.63374,0.63586,$20.20 ,"$11,427.60 ",21.2,Winning
1272,9/10/2015 9:00,Buy,9/10/2015 10:00,0.62823,0.62714,($11.90),"$11,415.70 ",-10.9,Losing
1273,9/10/2015 12:00,Sell,9/10/2015 12:00,0.63051,0.62941,$10.00 ,"$11,425.70 ",11,Winning
